호텔,리뷰 개수,긍정 리뷰 개수,부정 리뷰 개수,긍정 리뷰 비율,부정 리뷰 비율
어니언 안국,398,375,23,94.2,5.8
도토리가든,293,280,13,95.6,4.4
블루보틀 삼청 카페,259,237,22,91.5,8.5
프릳츠 원서점,217,208,9,95.9,4.1
오설록 티하우스 북촌점,198,194,4,98.0,2.0
소금집델리 안국,192,190,2,99.0,1.0
핑크래빗가든,160,160,0,100.0,0.0
오픈원,148,144,4,97.3,2.7
북촌김치재,125,121,4,96.8,3.2
땡스오트 안국,124,120,4,96.8,3.2
우드앤브릭,124,115,9,92.7,7.3
경춘자의라면땡기는날,124,118,6,95.2,4.8
모자이크 베이커리 북촌점,121,116,5,95.9,4.1
갓잇 안국점,119,118,1,99.2,0.8
안암,109,107,2,98.2,1.8
진작카키,106,105,1,99.1,0.9
청수정,104,93,11,89.4,10.6
백미당 삼청점,101,100,1,99.0,1.0
텅,99,93,6,93.9,6.1
연남토마 북촌점,98,93,5,94.9,5.1
도라보울,93,90,3,96.8,3.2
먹쉬돈나 삼청동점,93,85,8,91.4,8.6
커피브론즈,92,91,1,98.9,1.1
미트볼라운지 X 아날로그키친 삼청점,90,90,0,100.0,0.0
꿀밥상,88,79,9,89.8,10.2
조선김밥,87,83,4,95.4,4.6
로우루프,87,81,6,93.1,6.9
도트블랭킷 안국점,87,86,1,98.9,1.1
팔발라 삼청본점,84,76,8,90.5,9.5
청국장밥,83,76,7,91.6,8.4
브루다 안국,81,78,3,96.3,3.7
일월카츠,78,76,2,97.4,2.6
아티장 크로아상,78,77,1,98.7,1.3
브릭샌드 삼청점,78,78,0,100.0,0.0
스미스가좋아하는한옥,77,77,0,100.0,0.0
벨라쿠키 안국,76,74,2,97.4,2.6
RadioM 삼청점,74,69,5,93.2,6.8
정담은보쌈 북촌점,70,70,0,100.0,0.0
애호락,70,63,7,90.0,10.0
순이네가게,69,67,2,97.1,2.9
월영당 서울,69,67,2,97.1,2.9
카페진선,69,64,5,92.8,7.2
마음을담아내면,67,64,3,95.5,4.5
스미레돈카츠 안국점,67,64,3,95.5,4.5
플롭 안국,67,64,3,95.5,4.5
어텐디 북촌,66,64,2,97.0,3.0
회화나무,64,62,2,96.9,3.1
퀸즈베이커리 삼청점,64,61,3,95.3,4.7
부띠끄경성,64,64,0,100.0,0.0
만가타,63,63,0,100.0,0.0
슬로우파크,61,61,0,100.0,0.0
티테라피,60,58,2,96.7,3.3
대림국수 안국점,60,57,3,95.0,5.0
대장장이화덕피자,56,54,2,96.4,3.6
담미온 안국점,56,54,2,96.4,3.6
베테카텐,56,52,4,92.9,7.1
기와탭룸,55,53,2,96.4,3.6
밀과보리,55,55,0,100.0,0.0
노우즈안국,54,51,3,94.4,5.6
르꼬숑,54,50,4,92.6,7.4
아이사구아,54,51,3,94.4,5.6
북촌손만두 삼청동점,54,48,6,88.9,11.1
화양연화,54,46,8,85.2,14.8
인사동쭈꾸미,54,54,0,100.0,0.0
리틀버틀러,53,49,4,92.5,7.5
자작나무이야기,53,48,5,90.6,9.4
데시데,53,53,0,100.0,0.0
등촌샤브칼국수 안국역점,53,47,6,88.7,11.3
퀸넬브릴 삼청,51,50,1,98.0,2.0
이채 카페,50,50,0,100.0,0.0
리김밥 현대건설점,49,48,1,98.0,2.0
꽃밥에피다 북촌 친환경 그로서란트,49,47,2,95.9,4.1
커피 팩토리,49,47,2,95.9,4.1
마산해물아구찜,48,46,2,95.8,4.2
다락정,47,44,3,93.6,6.4
헤비스테이크 안국역점,46,46,0,100.0,0.0
오뉴하우스,46,46,0,100.0,0.0
시래기담은,45,45,0,100.0,0.0
비어셰프냐항,45,44,1,97.8,2.2
비원손칼국수,45,40,5,88.9,11.1
온6.5,43,39,4,90.7,9.3
비담 CAFE&BAR,43,41,2,95.3,4.7
델픽,43,41,2,95.3,4.7
몽중헌 안국점,42,41,1,97.6,2.4
네마커피 삼청점,41,41,0,100.0,0.0
국수명가,41,40,1,97.6,2.4
비엣 꽌,40,40,0,100.0,0.0
행복한 베이커리카페,38,37,1,97.4,2.6
황금정,38,35,3,92.1,7.9
아비꼬 안국역점,38,31,7,81.6,18.4
반타이,38,37,1,97.4,2.6
교촌치킨 안국점,37,35,2,94.6,5.4
쏘리 에스프레소바 창덕궁점,37,36,1,97.3,2.7
소선재,36,33,3,91.7,8.3
눈나무집,35,33,2,94.3,5.7
베르트,35,34,1,97.1,2.9
하프커피 안국,35,33,2,94.3,5.7
모퉁이네,35,32,3,91.4,8.6
피크닉,35,35,0,100.0,0.0
삼지,35,34,1,97.1,2.9
제이네,34,33,1,97.1,2.9
별궁식당,34,34,0,100.0,0.0
삼청빙수,34,32,2,94.1,5.9
계동피자,34,33,1,97.1,2.9
부영도가니탕,34,32,2,94.1,5.9
온마을,34,33,1,97.1,2.9
황칠가 안국점,34,31,3,91.2,8.8
미술관옆 돈까스,33,31,2,93.9,6.1
가례원,33,31,2,93.9,6.1
달,33,30,3,90.9,9.1
아재커피 북촌점 AZE COFFEE,33,31,2,93.9,6.1
콜디우드 안국,32,32,0,100.0,0.0
거울한옥 미러룸,32,25,7,78.1,21.9
커넥트계동,32,31,1,96.9,3.1
백년토종삼계탕,32,28,4,87.5,12.5
커피로드102,32,30,2,93.8,6.2
파툼,31,27,4,87.1,12.9
앙시엔,31,30,1,96.8,3.2
진국곰탕,30,29,1,96.7,3.3
호랑이카레,29,29,0,100.0,0.0
동백식당,28,28,0,100.0,0.0
길운구락부 & Bar,28,27,1,96.4,3.6
호아드 카페&갤러리,28,28,0,100.0,0.0
이화돈까스,27,26,1,96.3,3.7
카페포엠 북촌점,27,25,2,92.6,7.4
소온table,26,24,2,92.3,7.7
지유가오카핫초메 삼청점,26,26,0,100.0,0.0
감동칩스 북촌본점,26,23,3,88.5,11.5
다사리아,25,25,0,100.0,0.0
바스켓12 계동,25,25,0,100.0,0.0
삼방매,24,23,1,95.8,4.2
부빙,24,24,0,100.0,0.0
57th Cafe,24,22,2,91.7,8.3
카페3청,24,23,1,95.8,4.2
북촌호떡,24,24,0,100.0,0.0
그린마일커피 북촌점,24,22,2,91.7,8.3
mishmash,23,22,1,95.7,4.3
만수의정원,23,21,2,91.3,8.7
이밥,23,23,0,100.0,0.0
하궁,23,23,0,100.0,0.0
CFlamingo,23,21,2,91.3,8.7
두레 국립현대미술관서울점,23,18,5,78.3,21.7
까페 골목숲,22,20,2,90.9,9.1
재동맥주,22,18,4,81.8,18.2
언코르크드,22,21,1,95.5,4.5
콩두부사랑,22,22,0,100.0,0.0
푸드떼,21,20,1,95.2,4.8
봉궁,20,20,0,100.0,0.0
카페다겸,20,18,2,90.0,10.0
북촌연잎밥,20,20,0,100.0,0.0
북촌막국수,20,19,1,95.0,5.0
북촌쭈꾸미,19,17,2,89.5,10.5
고디바 삼청점,19,19,0,100.0,0.0
카페 르꽁뜨,19,18,1,94.7,5.3
빅스트로우 북촌점,19,19,0,100.0,0.0
뭉치바위,19,19,0,100.0,0.0
온더그라운드,19,19,0,100.0,0.0
삼청동김치찌개,19,19,0,100.0,0.0
실리그린,19,18,1,94.7,5.3
더베이커스테이블,18,16,2,88.9,11.1
스몰하우스카페,18,18,0,100.0,0.0
카페이드라,18,18,0,100.0,0.0
아키,18,18,0,100.0,0.0
탈스티,18,18,0,100.0,0.0
아재커피 삼청점,18,18,0,100.0,0.0
국수명가 가회점,17,17,0,100.0,0.0
프레스도넛 북촌다방점,17,16,1,94.1,5.9
삼청동 만정,17,15,2,88.2,11.8
삼청동우피,17,17,0,100.0,0.0
아트마,17,17,0,100.0,0.0
소격동60,17,17,0,100.0,0.0
더한옥,17,17,0,100.0,0.0
은설설렁탕,17,15,2,88.2,11.8
후스테이블,17,17,0,100.0,0.0
계동 이잌,17,16,1,94.1,5.9
진성옛날소머리국밥집,17,17,0,100.0,0.0
미돈,17,14,3,82.4,17.6
이니미니마니모,16,16,0,100.0,0.0
베커린 안국점,16,16,0,100.0,0.0
카페레이서,16,16,0,100.0,0.0
묘미,16,16,0,100.0,0.0
스미스가 좋아하는 테라스,16,16,0,100.0,0.0
화동옥,16,13,3,81.2,18.8
계동만담,16,16,0,100.0,0.0
편안한집,16,16,0,100.0,0.0
카페로쏘,15,15,0,100.0,0.0
국빈행성,15,14,1,93.3,6.7
코피발리안국점,15,15,0,100.0,0.0
와이엔,15,14,1,93.3,6.7
묵호횟집,15,15,0,100.0,0.0
카페죠꽁드,15,15,0,100.0,0.0
치킨하우스,14,12,2,85.7,14.3
서울풍경,14,13,1,92.9,7.1
모미지,14,14,0,100.0,0.0
공공재 커피클럽,14,14,0,100.0,0.0
안국정,13,13,0,100.0,0.0
와옥,13,13,0,100.0,0.0
아붕,13,12,1,92.3,7.7
고메오드,13,13,0,100.0,0.0
아꼬떼,12,11,1,91.7,8.3
원조부대고기,12,12,0,100.0,0.0
정사장,12,12,0,100.0,0.0
북촌애가삼도예카페,12,11,1,91.7,8.3
전다,12,12,0,100.0,0.0
단상,12,12,0,100.0,0.0
달별,12,12,0,100.0,0.0
무에,12,12,0,100.0,0.0
큰기와집,12,10,2,83.3,16.7
북촌스토리,12,12,0,100.0,0.0
플로라,12,11,1,91.7,8.3
삼청동 로마네꽁띠,12,12,0,100.0,0.0
북촌집,12,11,1,91.7,8.3
키즈나,12,10,2,83.3,16.7
현닭매운탕,11,11,0,100.0,0.0
크렘브,11,11,0,100.0,0.0
브람스,11,11,0,100.0,0.0
북촌진곰탕,11,11,0,100.0,0.0
베이킹 도우,11,11,0,100.0,0.0
북촌한식뷔페,11,11,0,100.0,0.0
마칸틴,10,10,0,100.0,0.0
고이커피,10,10,0,100.0,0.0
비어있는 삶,10,10,0,100.0,0.0
라 끌레,10,9,1,90.0,10.0
다운타우너안국점,10,9,1,90.0,10.0
카페 델 꼬또네 북촌계동점,10,10,0,100.0,0.0
안동손칼국수 계동점,10,10,0,100.0,0.0
마나님 레시피,10,6,4,60.0,40.0
커피인뜨락,10,10,0,100.0,0.0
CAFE D_55,10,10,0,100.0,0.0
소소,10,10,0,100.0,0.0
아다지에토,9,9,0,100.0,0.0
한경헌,9,8,1,88.9,11.1
월하보이,9,9,0,100.0,0.0
권사부순대국 삼청점,9,9,0,100.0,0.0
파인콘,9,9,0,100.0,0.0
마산복집,9,8,1,88.9,11.1
깡통만두,8,8,0,100.0,0.0
런던베이글뮤지엄,8,6,2,75.0,25.0
카페호미,8,7,1,87.5,12.5
랜디스도넛안국점,8,7,1,87.5,12.5
왕짱구식당,8,8,0,100.0,0.0
와인이지,8,8,0,100.0,0.0
동네커피,8,8,0,100.0,0.0
루이스 카페,8,8,0,100.0,0.0
기차 앤 초밥,8,8,0,100.0,0.0
한뫼촌,8,7,1,87.5,12.5
보드레 안다미로,7,7,0,100.0,0.0
갤러리더스퀘어,7,7,0,100.0,0.0
더블컵커피,7,7,0,100.0,0.0
행복두배통다리치킨,7,7,0,100.0,0.0
신일룡의 호두파이,7,7,0,100.0,0.0
돌담집,7,7,0,100.0,0.0
수왕,6,6,0,100.0,0.0
카타딘,6,5,1,83.3,16.7
501커피,6,6,0,100.0,0.0
용수산 비원점,6,6,0,100.0,0.0
잇아웃,6,6,0,100.0,0.0
삼청동수제비,6,5,1,83.3,16.7
갈로팡,6,6,0,100.0,0.0
향나무세그루,6,6,0,100.0,0.0
유즈라멘안국점,6,6,0,100.0,0.0
남원,6,6,0,100.0,0.0
단풍나무집 삼청점,6,6,0,100.0,0.0
카페공드리,6,6,0,100.0,0.0
톤티커피,5,5,0,100.0,0.0
레이어드안국점,5,4,1,80.0,20.0
중경삼림,5,5,0,100.0,0.0
카페 No37,5,5,0,100.0,0.0
3안,5,4,1,80.0,20.0
맛다오리구이,5,5,0,100.0,0.0
비원커피,5,5,0,100.0,0.0
첫번째집,5,5,0,100.0,0.0
파티세리희원,5,5,0,100.0,0.0
장원식당,5,5,0,100.0,0.0
종로삼대복집,5,5,0,100.0,0.0
로씨니,5,5,0,100.0,0.0
오니,5,5,0,100.0,0.0
개성철렵 & 루프탑 나위,4,4,0,100.0,0.0
코닉,4,4,0,100.0,0.0
망고랑 본점,4,3,1,75.0,25.0
북촌삼계탕,4,4,0,100.0,0.0
북촌도담,4,3,1,75.0,25.0
카페노티드안국점,4,4,0,100.0,0.0
더 레스토랑,4,4,0,100.0,0.0
이태리탁,4,3,1,75.0,25.0
풍경,4,4,0,100.0,0.0
의정부부대고기,4,3,1,75.0,25.0
산체스 막걸리,4,4,0,100.0,0.0
지밥,4,4,0,100.0,0.0
카페얼티밋,4,4,0,100.0,0.0
소금집델리안국점,3,3,0,100.0,0.0
스기모토,3,3,0,100.0,0.0
차마시는뜰,3,3,0,100.0,0.0
보이차전문점 명가원,3,3,0,100.0,0.0
천하보쌈,3,3,0,100.0,0.0
곰초밥,3,3,0,100.0,0.0
핸디크레프티,2,2,0,100.0,0.0
블루몬테,2,1,1,50.0,50.0
Floor For Fiction,2,2,0,100.0,0.0
정원고깃집,2,2,0,100.0,0.0
정애쿠키,2,2,0,100.0,0.0
서울서둘째로잘하는집,2,2,0,100.0,0.0
밀양손만두,2,2,0,100.0,0.0
가배도삼청점,2,2,0,100.0,0.0
률,2,2,0,100.0,0.0
몽테뉴,2,2,0,100.0,0.0
수와래,2,2,0,100.0,0.0
풍년쌀농산,1,1,0,100.0,0.0
커피방앗간,1,0,1,0.0,100.0
북촌손만두북촌점,1,1,0,100.0,0.0
테라로사,1,1,0,100.0,0.0
배스킨라빈스삼청마당점,1,1,0,100.0,0.0
The 0123 샌드위치,1,1,0,100.0,0.0
희 사블레,1,1,0,100.0,0.0
아따블르,1,1,0,100.0,0.0
콩두 점점,1,1,0,100.0,0.0
북촌 호떡나들이,1,1,0,100.0,0.0
안국 153,1,1,0,100.0,0.0
디어와인,1,1,0,100.0,0.0
송재헌,1,1,0,100.0,0.0
치골뱅 비어뱅,1,1,0,100.0,0.0
오레노라멘,1,1,0,100.0,0.0
이디야커피북촌마을점,1,1,0,100.0,0.0
