호텔,리뷰 개수,긍정 리뷰 개수,부정 리뷰 개수,긍정 리뷰 비율,부정 리뷰 비율
고든램지 스트리트 피자 서울숲점,237,212,25,89.5,10.5
쎄콩데live,233,231,2,99.1,0.9
성수옥상,227,225,2,99.1,0.9
누데이크 성수점,195,178,17,91.3,8.7
크림라벨 서울숲 본점,182,176,6,96.7,3.3
캐주얼성수,168,167,1,99.4,0.6
테니,160,155,5,96.9,3.1
노이,154,149,5,96.8,3.2
테디스오븐,149,145,4,97.3,2.7
데우스 카페 성수점,140,137,3,97.9,2.1
신사소곱창 성수점,134,131,3,97.8,2.2
보마켓 서울숲점,132,126,6,95.5,4.5
보끔당 성수점,131,130,1,99.2,0.8
메종 파이프그라운드,127,123,4,96.9,3.1
모모야 성수점,124,121,3,97.6,2.4
퍼먼트,121,115,6,95.0,5.0
카멜커피 7호점,120,110,10,91.7,8.3
타이거풀,119,119,0,100.0,0.0
미도인 성수,118,114,4,96.6,3.4
두 투리에,116,115,1,99.1,0.9
권식족발 성수본점,112,111,1,99.1,0.9
고집132 성수본점,109,109,0,100.0,0.0
스케줄 성수,106,101,5,95.3,4.7
성수온실,103,101,2,98.1,1.9
성수옥아궁지 성수본점,103,102,1,99.0,1.0
마씨,103,103,0,100.0,0.0
쎈느Scene,101,97,4,96.0,4.0
연남토마 성수점,100,96,4,96.0,4.0
위드번,100,98,2,98.0,2.0
팔각도 성수역점,98,96,2,98.0,2.0
천하제일 솥뚜껑,98,95,3,96.9,3.1
투썸플레이스 성수skv타워점,97,93,4,95.9,4.1
투데이즈이너프,96,94,2,97.9,2.1
로우키,96,88,8,91.7,8.3
맘스터치 성수역점,96,87,9,90.6,9.4
로우커피스탠드,96,92,4,95.8,4.2
파머스카페,95,89,6,93.7,6.3
정돈 성수점,93,87,6,93.5,6.5
이오로비스트로,91,89,2,97.8,2.2
롯데리아 성수역점,88,77,11,87.5,12.5
올댓커피 포레스트점,87,85,2,97.7,2.3
라무라 성수,87,80,7,92.0,8.0
꽌코이,85,84,1,98.8,1.2
크리스탈드래곤 성수낙낙점,85,81,4,95.3,4.7
훼미리손칼국수보쌈,83,81,2,97.6,2.4
르프리크,83,82,1,98.8,1.2
잠수교집 성수 직영점,83,79,4,95.2,4.8
카카모루 성수점,82,82,0,100.0,0.0
훔볼트,81,77,4,95.1,4.9
까망,81,80,1,98.8,1.2
젠젠 성수점,81,78,3,96.3,3.7
문츠 바베큐,81,81,0,100.0,0.0
천상가옥,80,77,3,96.2,3.8
앤드밀 성수점,80,72,8,90.0,10.0
강남면옥 성수점,80,77,3,96.2,3.8
메가MGC커피 서울숲역점,80,74,6,92.5,7.5
누메로도스,79,74,5,93.7,6.3
만학,78,75,3,96.2,3.8
베티버 성수,78,77,1,98.7,1.3
세디치,78,77,1,98.7,1.3
망티커피 성수점,77,69,8,89.6,10.4
윤경양식당,75,72,3,96.0,4.0
후라토식당 성수점,75,73,2,97.3,2.7
써브웨이 성수역점,75,68,7,90.7,9.3
팜티진쌀국수,74,72,2,97.3,2.7
칼,73,70,3,95.9,4.1
벱,73,73,0,100.0,0.0
포어플랜,73,71,2,97.3,2.7
미쁘동 서울숲,72,65,7,90.3,9.7
꿉당 성수점,72,66,6,91.7,8.3
메가MGC커피 성수일로점,71,63,8,88.7,11.3
오프트,71,70,1,98.6,1.4
노모어피자 서울숲점,70,64,6,91.4,8.6
대성갈비,70,68,2,97.1,2.9
기러기둥지 성수,69,61,8,88.4,11.6
뚝 다이닝,68,65,3,95.6,4.4
서울바나나,68,61,7,89.7,10.3
스윗바이브,67,65,2,97.0,3.0
쿠나,67,65,2,97.0,3.0
성수노루,66,63,3,95.5,4.5
"밤의, 와인테라스&낮의, 피자테라스",66,66,0,100.0,0.0
노가리마켓 서울숲,66,55,11,83.3,16.7
엘더버거,66,63,3,95.5,4.5
소인수서울 본점,65,60,5,92.3,7.7
홍콩반점0410 성수역점,65,65,0,100.0,0.0
할머니의 레시피,65,63,2,96.9,3.1
더블해피니스 성수,64,63,1,98.4,1.6
성수이루다,64,64,0,100.0,0.0
아카이브 서울,64,64,0,100.0,0.0
빠오즈푸 서울숲직영점,64,59,5,92.2,7.8
포도젝트,63,63,0,100.0,0.0
하프커피 성수,63,58,5,92.1,7.9
바이레인,62,61,1,98.4,1.6
포배럴카페,62,59,3,95.2,4.8
도도한면 성수본점,62,61,1,98.4,1.6
화화담 성수,61,57,4,93.4,6.6
춘배버거,61,58,3,95.1,4.9
오레노카츠 성수본점,61,56,5,91.8,8.2
일일향 성수10호점,61,55,6,90.2,9.8
잇샐러드 성수점,61,60,1,98.4,1.6
산들김밥,60,57,3,95.0,5.0
갓잇 성수 홀리워터점,60,60,0,100.0,0.0
헤비스테이크 성수점,59,56,3,94.9,5.1
해밀칼국수&김밥,59,56,3,94.9,5.1
호랑이 초밥,59,59,0,100.0,0.0
오늘애김밥 성수역점,58,54,4,93.1,6.9
오늘와인한잔 성수가든점,58,54,4,93.1,6.9
신라다랑원 성수점,58,58,0,100.0,0.0
티룸,58,55,3,94.8,5.2
중화카츠 서울숲,57,56,1,98.2,1.8
브라운래빗 서울숲점,57,55,2,96.5,3.5
밥밥디라라 뚝섬역점,57,56,1,98.2,1.8
정선부뚜막,57,53,4,93.0,7.0
카멜커피 성수점,57,51,6,89.5,10.5
체다앤올리,57,57,0,100.0,0.0
서울숲누룽지통닭구이,56,53,3,94.6,5.4
칙피스 성수점,56,53,3,94.6,5.4
가조쿠,56,54,2,96.4,3.6
강호연파 성수 숲속산장점,56,49,7,87.5,12.5
동빙고 성수점,55,50,5,90.9,9.1
평이담백뼈칼국수 성수점,55,54,1,98.2,1.8
다운타우너 성수 피치스,55,55,0,100.0,0.0
오우드 성수1호점,55,51,4,92.7,7.3
르셀,55,53,2,96.4,3.6
밸런스포케 서울숲점,55,54,1,98.2,1.8
부우이,55,52,3,94.5,5.5
목금,54,54,0,100.0,0.0
강남교자 뚝섬역점,54,53,1,98.1,1.9
마크69,54,43,11,79.6,20.4
카린지_린가네 스낵바,54,54,0,100.0,0.0
성수정원,53,53,0,100.0,0.0
니드스윗,53,52,1,98.1,1.9
더반 베를린 성수점,53,50,3,94.3,5.7
프롤라,53,52,1,98.1,1.9
마리오네,52,49,3,94.2,5.8
달래해장 성수점,52,48,4,92.3,7.7
발렁스,52,50,2,96.2,3.8
효자동목고기,52,52,0,100.0,0.0
도렐 성수점,52,46,6,88.5,11.5
쿠키샾,52,48,4,92.3,7.7
탕화쿵푸마라탕 성수동지점,51,48,3,94.1,5.9
에이투비 Cafe&Bar,51,47,4,92.2,7.8
성수삐딱,51,45,6,88.2,11.8
어묵나라,51,48,3,94.1,5.9
신사동 벼락집,51,51,0,100.0,0.0
201호,51,49,2,96.1,3.9
페이퍼 플레이트,51,50,1,98.0,2.0
멘야코노하 성수,50,50,0,100.0,0.0
스시메이 성수점,50,50,0,100.0,0.0
오우도,50,49,1,98.0,2.0
stdo,50,47,3,94.0,6.0
소년식당,49,43,6,87.8,12.2
사람사는 고깃집 김일도 성수점,49,46,3,93.9,6.1
무브모브 성수,49,47,2,95.9,4.1
감도 성수점,49,45,4,91.8,8.2
제제,49,45,4,91.8,8.2
훈연,49,47,2,95.9,4.1
버섯집,48,44,4,91.7,8.3
금금 성수점,48,47,1,97.9,2.1
오스테리아 파로,48,48,0,100.0,0.0
마하차이 서울숲점,48,41,7,85.4,14.6
파르코,48,43,5,89.6,10.4
뚝도농원,48,38,10,79.2,20.8
슈퍼말차 성수,48,46,2,95.8,4.2
예빈당,47,46,1,97.9,2.1
도치피자 성수,47,47,0,100.0,0.0
루디먼트,47,47,0,100.0,0.0
계월 곰탕,47,45,2,95.7,4.3
nothingmatters,46,45,1,97.8,2.2
왕삼겹정육식당,46,45,1,97.8,2.2
라에비뉴,46,44,2,95.7,4.3
HBC coffee,46,44,2,95.7,4.3
다포케 성수점,45,42,3,93.3,6.7
BNHR,45,43,2,95.6,4.4
모센즈스위트 성수점,45,43,2,95.6,4.4
무식당 성수본점,45,43,2,95.6,4.4
오와리 본점,45,45,0,100.0,0.0
미엘릿,45,41,4,91.1,8.9
캐스터네츠 서울숲점,45,45,0,100.0,0.0
기후,45,43,2,95.6,4.4
스시오오모토,45,44,1,97.8,2.2
리얼월드 성수,45,41,4,91.1,8.9
성수피글렛,44,43,1,97.7,2.3
컴오프,44,42,2,95.5,4.5
디플랫 성수,44,40,4,90.9,9.1
필살기CAFE,44,44,0,100.0,0.0
공차 성수역점,44,44,0,100.0,0.0
홍화돈,43,41,2,95.3,4.7
시옹마오,43,43,0,100.0,0.0
매머드익스프레스 성수역점,43,43,0,100.0,0.0
남다른본가닭한마리 성수점,43,40,3,93.0,7.0
레이더,43,38,5,88.4,11.6
미아논나,42,38,4,90.5,9.5
HDD피자,42,39,3,92.9,7.1
엘레멘츠,42,42,0,100.0,0.0
써브웨이 서울숲점,42,35,7,83.3,16.7
공차 서울숲점,42,40,2,95.2,4.8
고운 돈카츠,42,42,0,100.0,0.0
등촌샤브칼국수 성수점,41,40,1,97.6,2.4
빽다방 화양사거리점,41,41,0,100.0,0.0
청정옥,41,40,1,97.6,2.4
아울림,41,41,0,100.0,0.0
유가츠,41,41,0,100.0,0.0
춘하추우동,41,41,0,100.0,0.0
에피타이트,41,40,1,97.6,2.4
미디엄스톤 성수점,41,40,1,97.6,2.4
까치화방 성수낙낙점,41,40,1,97.6,2.4
오토김밥 서울숲점,41,39,2,95.1,4.9
청키드 성수점,41,40,1,97.6,2.4
강다짐 삼각김밥 성수점,40,38,2,95.0,5.0
매머드익스프레스 뚝섬역점,40,36,4,90.0,10.0
구욱희씨 서울숲점,40,35,5,87.5,12.5
본노엘 성수점,40,36,4,90.0,10.0
"여기 런던 Here, london",40,40,0,100.0,0.0
24시전주명가콩나물국밥 서울성수점,40,37,3,92.5,7.5
카페&펍 연무장,40,37,3,92.5,7.5
희릿,40,39,1,97.5,2.5
지우관,40,39,1,97.5,2.5
반포식스 성수점,40,37,3,92.5,7.5
퀴버 서울숲,40,35,5,87.5,12.5
bd버거 성수,40,38,2,95.0,5.0
비스트로성수,40,39,1,97.5,2.5
글로우,40,35,5,87.5,12.5
업사이드커피,39,35,4,89.7,10.3
계모임,39,39,0,100.0,0.0
성수면당,39,38,1,97.4,2.6
힘이나는커피생활 성수2호점,39,38,1,97.4,2.6
럭럭카페,39,39,0,100.0,0.0
피키니키 라자냐,39,38,1,97.4,2.6
청담순대국,39,39,0,100.0,0.0
피자시즌,39,39,0,100.0,0.0
빽다방 성수역롯데캐슬점,39,37,2,94.9,5.1
굿갓레스토랑 성수역점,38,38,0,100.0,0.0
하이라인,38,37,1,97.4,2.6
스텀필즈커피,38,34,4,89.5,10.5
원기옥,38,36,2,94.7,5.3
어묵나라 뚝섬점,38,36,2,94.7,5.3
구아바,37,34,3,91.9,8.1
빽다방 성수뚝도점,37,35,2,94.6,5.4
봉쥬르,37,35,2,94.6,5.4
컴포즈커피 화양사거리점,37,35,2,94.6,5.4
소바마에,37,36,1,97.3,2.7
바르다김선생 서울숲점,37,23,14,62.2,37.8
롸카두들 내쉬빌 핫치킨 성수점,37,34,3,91.9,8.1
성수우동,37,37,0,100.0,0.0
뚜레쥬르 성수역점,37,36,1,97.3,2.7
퍼응언쌀국수,36,36,0,100.0,0.0
짬뽕위에더짬뽕,36,33,3,91.7,8.3
오와리 뚝섬점,36,35,1,97.2,2.8
패티앤베지스 성수,36,36,0,100.0,0.0
비파서울,36,34,2,94.4,5.6
벨라스가든 서울숲점,36,34,2,94.4,5.6
멘야마쯔리 성수점,36,34,2,94.4,5.6
포동푸딩,36,35,1,97.2,2.8
하오마라,36,35,1,97.2,2.8
육품,36,36,0,100.0,0.0
단일서울,36,36,0,100.0,0.0
다로베,36,35,1,97.2,2.8
백정돈공장,36,35,1,97.2,2.8
담미온 성수점,35,32,3,91.4,8.6
성수김밥 퍼니텅,35,34,1,97.1,2.9
타크,35,35,0,100.0,0.0
어메이징브루잉컴퍼니,35,35,0,100.0,0.0
동대문엽기떡볶이 성수점,35,34,1,97.1,2.9
누메로뜨레쓰,35,34,1,97.1,2.9
샐러디 성수점,35,33,2,94.3,5.7
북촌손만두 성수역점,35,34,1,97.1,2.9
세밀,35,35,0,100.0,0.0
어퍼룸,35,35,0,100.0,0.0
마하차이 성수본점,35,34,1,97.1,2.9
어라운드데이,35,35,0,100.0,0.0
성일식당아들네,34,34,0,100.0,0.0
버거보이 성수낙낙점,34,33,1,97.1,2.9
빽다방 뚝섬역점,34,33,1,97.1,2.9
도죠,34,33,1,97.1,2.9
피자니스타 서울숲점,34,33,1,97.1,2.9
버니타운,34,34,0,100.0,0.0
성수닭발,34,31,3,91.2,8.8
한음,34,32,2,94.1,5.9
하노이102,34,33,1,97.1,2.9
푸르너스가든 서울숲,33,32,1,97.0,3.0
탐앤탐스 성수1호점,33,32,1,97.0,3.0
하늘분식,33,33,0,100.0,0.0
타논55,33,30,3,90.9,9.1
시즈니,33,32,1,97.0,3.0
긴밤,33,33,0,100.0,0.0
대낚식당,33,30,3,90.9,9.1
누에종,33,32,1,97.0,3.0
파티세리 아모니,33,33,0,100.0,0.0
비스트리오,33,33,0,100.0,0.0
더카페 서울숲역점,33,31,2,93.9,6.1
신선식탁 성수역점,33,33,0,100.0,0.0
포맨스,33,32,1,97.0,3.0
힘이나는커피생활 성수3호점,32,31,1,96.9,3.1
업사이드커피 뚝섬점,32,30,2,93.8,6.2
성수맥주,32,30,2,93.8,6.2
구펠,32,31,1,96.9,3.1
FINZ 핀즈,32,31,1,96.9,3.1
타코마이너,32,32,0,100.0,0.0
차이나플레인 서울숲점,32,30,2,93.8,6.2
어피스앤드피스,32,31,1,96.9,3.1
타치노미바이토라,32,27,5,84.4,15.6
코치,32,32,0,100.0,0.0
풍조미역 성수본점,32,31,1,96.9,3.1
성수부두,32,30,2,93.8,6.2
청춘고깃간,32,30,2,93.8,6.2
이랑칼국수,31,29,2,93.5,6.5
조개도,31,31,0,100.0,0.0
오버도즈도넛앤커피,31,31,0,100.0,0.0
유어네이키드치즈,31,30,1,96.8,3.2
밋보어 카페 & 이터리 by 에디션덴마크,31,30,1,96.8,3.2
울림,31,30,1,96.8,3.2
탄스이카부츠,31,29,2,93.5,6.5
소바식당,31,29,2,93.5,6.5
뚝도살롱,31,31,0,100.0,0.0
문득,31,30,1,96.8,3.2
푸드갤러리빈,31,31,0,100.0,0.0
역전할머니맥주 성수점,30,27,3,90.0,10.0
화이트글래스,30,29,1,96.7,3.3
토리아에즈,30,30,0,100.0,0.0
래뮤,30,29,1,96.7,3.3
봉봉디저트카페,30,30,0,100.0,0.0
토마토김밥 뚝섬역점,30,29,1,96.7,3.3
야드 서울,30,29,1,96.7,3.3
일구공 성수 본점,30,29,1,96.7,3.3
아키야마,30,30,0,100.0,0.0
우시야 성수점,30,29,1,96.7,3.3
경성찹쌀꽈배기 성수역점,30,30,0,100.0,0.0
차일디쉬,30,30,0,100.0,0.0
화포식당성수,30,30,0,100.0,0.0
더벤티 성수카페거리점,30,29,1,96.7,3.3
빅쭌부대찌개 성수점,30,27,3,90.0,10.0
심야의 숲,30,30,0,100.0,0.0
샹도르본사직영점,29,23,6,79.3,20.7
짬뽕품격,29,27,2,93.1,6.9
폴인레미유 성수점,29,28,1,96.6,3.4
라온석갈비,29,28,1,96.6,3.4
투파인드피터 서울성수점,29,27,2,93.1,6.9
Pauline CoffeeBar,29,28,1,96.6,3.4
매머드익스프레스 서울숲코오롱1차점,28,25,3,89.3,10.7
시원,28,28,0,100.0,0.0
이로우,28,27,1,96.4,3.6
플디 성수점,28,28,0,100.0,0.0
스테치,28,26,2,92.9,7.1
세광양대창 성수점,28,21,7,75.0,25.0
꼬치상점,28,25,3,89.3,10.7
헬렐레,28,25,3,89.3,10.7
키베이커리,28,28,0,100.0,0.0
포지티브 서울숲,28,28,0,100.0,0.0
성수속향연,28,26,2,92.9,7.1
행복한식당,28,27,1,96.4,3.6
아오미,28,26,2,92.9,7.1
전주콩나물국밥,27,27,0,100.0,0.0
하우트제곱,27,26,1,96.3,3.7
눈꽃돼지,27,27,0,100.0,0.0
마루제면소,27,24,3,88.9,11.1
블루너리,27,25,2,92.6,7.4
매머드익스프레스 성수역SKV1점,27,24,3,88.9,11.1
오근내7닭갈비,27,26,1,96.3,3.7
꼬모윤 성수,27,25,2,92.6,7.4
우마텐 텐동,27,23,4,85.2,14.8
빙봉,27,24,3,88.9,11.1
록멘,27,26,1,96.3,3.7
란돌프서울숲,27,26,1,96.3,3.7
올로,27,26,1,96.3,3.7
가가호호 성수점,27,26,1,96.3,3.7
한촌설렁탕 성수뚝도점,27,26,1,96.3,3.7
아후 Ahoo,26,26,0,100.0,0.0
오와리 주막,26,26,0,100.0,0.0
성수로운,26,26,0,100.0,0.0
란칼국수,26,25,1,96.2,3.8
퍼틴 성수점,26,25,1,96.2,3.8
업사이드커피 연무장점,26,24,2,92.3,7.7
메시,26,24,2,92.3,7.7
성일정육식당,26,26,0,100.0,0.0
그린한식뷔페,26,26,0,100.0,0.0
송흥,26,25,1,96.2,3.8
페스티발,26,25,1,96.2,3.8
사운드 플래닛,26,25,1,96.2,3.8
칠칠칠,26,25,1,96.2,3.8
써니눅,26,26,0,100.0,0.0
라무진 성수카페거리점,26,24,2,92.3,7.7
성수아구찜,25,25,0,100.0,0.0
미락바지락칼국수,25,24,1,96.0,4.0
이북집 찹쌀순대 성수점,25,22,3,88.0,12.0
미오 도쿄 다이닝,25,22,3,88.0,12.0
전자방,25,24,1,96.0,4.0
민정식당 서울숲 직영점,25,23,2,92.0,8.0
성수일구,25,25,0,100.0,0.0
뚝섬포구,25,25,0,100.0,0.0
커피온리 뚝섬역점,25,25,0,100.0,0.0
히즈빈스 성수점,25,25,0,100.0,0.0
마봉양꼬치 성수점,25,22,3,88.0,12.0
라성천사,25,25,0,100.0,0.0
저스트텐동 성수점,25,23,2,92.0,8.0
스프레이,25,25,0,100.0,0.0
마블상회,25,24,1,96.0,4.0
성수오오,25,25,0,100.0,0.0
비스트로류,25,22,3,88.0,12.0
슈에뜨펍,25,25,0,100.0,0.0
유스트레스,25,25,0,100.0,0.0
곤카츠 GONKATSU,25,23,2,92.0,8.0
기미사 성수,24,22,2,91.7,8.3
홍보석,24,24,0,100.0,0.0
웨이크앤베이크 성수,24,23,1,95.8,4.2
뚝배기양평해장국 성수점,24,23,1,95.8,4.2
온센 성수점,24,24,0,100.0,0.0
동구식당,24,22,2,91.7,8.3
성수차이나,24,24,0,100.0,0.0
도담순대국 성수본점,24,21,3,87.5,12.5
덕,24,21,3,87.5,12.5
연탄불꼼장어,24,24,0,100.0,0.0
수원원조갈비,24,22,2,91.7,8.3
우웨이탕,24,21,3,87.5,12.5
위풍당당족발,24,23,1,95.8,4.2
술있는식탁,24,23,1,95.8,4.2
메종 성수돈,23,23,0,100.0,0.0
성수시루,23,23,0,100.0,0.0
라무진 성수점,23,22,1,95.7,4.3
엘몰리노,23,23,0,100.0,0.0
나누리잡화점,23,20,3,87.0,13.0
벼리다,23,22,1,95.7,4.3
리틀포레스트,23,22,1,95.7,4.3
써니브레드,23,23,0,100.0,0.0
라비옹카페,23,21,2,91.3,8.7
위키드와이프,23,22,1,95.7,4.3
샌드카베,23,22,1,95.7,4.3
카페요아정,23,22,1,95.7,4.3
이월로스터스 성수점,23,23,0,100.0,0.0
은빛물결 황금낙지,23,23,0,100.0,0.0
혁신풍천민물장어 서울숲점,23,22,1,95.7,4.3
역삼칼국수,23,23,0,100.0,0.0
보이어,23,22,1,95.7,4.3
커피스미스,23,22,1,95.7,4.3
교촌치킨 성수역점,23,23,0,100.0,0.0
이가네양꼬치 성수직영점,22,21,1,95.5,4.5
퍼멘티드 고스트,22,22,0,100.0,0.0
왕돈까스&왕냉면 뚝섬점,22,21,1,95.5,4.5
아이오쓰리 에이스하이엔드점,22,22,0,100.0,0.0
마르코웤스,22,22,0,100.0,0.0
밀카페 우프,22,22,0,100.0,0.0
아니마토,22,22,0,100.0,0.0
대포차,22,22,0,100.0,0.0
스시이치바,22,22,0,100.0,0.0
퓨엘커피,22,22,0,100.0,0.0
신의한국수본점,22,22,0,100.0,0.0
밀본 본점,22,21,1,95.5,4.5
나미 곰식당,22,20,2,90.9,9.1
아타리,22,21,1,95.5,4.5
당도,22,22,0,100.0,0.0
창창커피,22,20,2,90.9,9.1
황금어장,22,20,2,90.9,9.1
매머드익스프레스 성수우림점,22,22,0,100.0,0.0
명국수,21,21,0,100.0,0.0
파리바게뜨 성수코오롱점,21,20,1,95.2,4.8
원스카페,21,21,0,100.0,0.0
담소소사골순대육개장 서울숲점,21,21,0,100.0,0.0
스시류블랙 성수낙낙점,21,20,1,95.2,4.8
쑤쑤타이,21,17,4,81.0,19.0
마이올드포스터,21,19,2,90.5,9.5
해피캔디쿠키,21,21,0,100.0,0.0
더즌오이스터 성수,21,18,3,85.7,14.3
팩피,21,20,1,95.2,4.8
모퉁이와플,21,21,0,100.0,0.0
광장족발 본가,21,20,1,95.2,4.8
고공 성수본점,21,20,1,95.2,4.8
스시포레,21,21,0,100.0,0.0
제일 참 순대국,21,19,2,90.5,9.5
리틀바잇모어,21,20,1,95.2,4.8
죽이야기 서울 뚝섬역점,21,19,2,90.5,9.5
회사식당,21,21,0,100.0,0.0
윤경,21,19,2,90.5,9.5
르베지왕 성수공간,21,20,1,95.2,4.8
곳온니플레이스 성수낙낙,21,21,0,100.0,0.0
부산밀면,21,20,1,95.2,4.8
플래닝샐러드,21,20,1,95.2,4.8
감요,20,20,0,100.0,0.0
김밥천국 서울숲점,20,20,0,100.0,0.0
기왕생고기,20,20,0,100.0,0.0
고기다 성수점,20,20,0,100.0,0.0
한서칼국수,20,20,0,100.0,0.0
바오 서울,20,20,0,100.0,0.0
뚝섬숯불갈비,20,18,2,90.0,10.0
민속김밥,20,19,1,95.0,5.0
우리칼국수,20,20,0,100.0,0.0
달구벌반점,20,19,1,95.0,5.0
진짜배기명태촌 서울성수점,20,20,0,100.0,0.0
안뜰 생선구이동태대구탕 뚝섬역점,20,20,0,100.0,0.0
높은산,20,20,0,100.0,0.0
진도부대찌개,20,19,1,95.0,5.0
그레이트커피 서울숲점,20,17,3,85.0,15.0
무국적주점 거실,20,20,0,100.0,0.0
에이셉피자 성수점,20,18,2,90.0,10.0
더반푸드,20,20,0,100.0,0.0
코트사이드,20,19,1,95.0,5.0
뚜르띠에르,20,19,1,95.0,5.0
우콘카레,20,20,0,100.0,0.0
브루잉 세레모니,20,19,1,95.0,5.0
피자스쿨 뚝섬역점,20,20,0,100.0,0.0
그리너 성수1가점,20,18,2,90.0,10.0
용이네,20,19,1,95.0,5.0
이트앤드링크,20,18,2,90.0,10.0
순남시래기 서울숲역점,19,19,0,100.0,0.0
샵아지트,19,18,1,94.7,5.3
굴림,19,19,0,100.0,0.0
일심정,19,17,2,89.5,10.5
성수동 간판없는집,19,19,0,100.0,0.0
세븐갈비,19,17,2,89.5,10.5
보스코 에스프레소 바,19,19,0,100.0,0.0
옛골감자탕,19,18,1,94.7,5.3
녹마이,19,18,1,94.7,5.3
BELOW SEONGSOO,19,17,2,89.5,10.5
스탠드업플리즈바이턴온,19,18,1,94.7,5.3
인치스,19,19,0,100.0,0.0
그린랩,19,19,0,100.0,0.0
패티패티,19,19,0,100.0,0.0
산내골칼국수,19,19,0,100.0,0.0
노랑통닭 성수점,19,19,0,100.0,0.0
리옹베이커리,19,19,0,100.0,0.0
커피식구 성수센터,19,18,1,94.7,5.3
서래왕차돌 뚝섬역점,19,19,0,100.0,0.0
까사다루아,19,19,0,100.0,0.0
플러드,19,18,1,94.7,5.3
웜히어,19,18,1,94.7,5.3
천미향,19,19,0,100.0,0.0
오시요거트,19,18,1,94.7,5.3
착한짜장,19,17,2,89.5,10.5
ONE BEAN카페,19,19,0,100.0,0.0
성수일미락,19,17,2,89.5,10.5
토라식당,19,19,0,100.0,0.0
위스위츠,18,17,1,94.4,5.6
베르두레 성수점,18,18,0,100.0,0.0
글레이셔박,18,17,1,94.4,5.6
수제양정순대국 본점,18,18,0,100.0,0.0
쁘띠 다이너,18,18,0,100.0,0.0
현대옥 서울숲점,18,18,0,100.0,0.0
오부대찌개,18,18,0,100.0,0.0
방춘리,18,17,1,94.4,5.6
라프레플루트,18,18,0,100.0,0.0
희정보감족,18,18,0,100.0,0.0
홍낭자와김도령 성수낙낙점,18,17,1,94.4,5.6
후라이드참잘하는집 성수점,18,18,0,100.0,0.0
매너커피,18,16,2,88.9,11.1
최가네 국수 김밥,18,17,1,94.4,5.6
닭한마리,18,18,0,100.0,0.0
camouflage coffee,18,18,0,100.0,0.0
반상회 성수,18,18,0,100.0,0.0
이키가이,18,18,0,100.0,0.0
성수초밥 성수점,18,18,0,100.0,0.0
호호반점 성수낙낙점,18,15,3,83.3,16.7
한경화설렁탕,18,17,1,94.4,5.6
완백부대찌개삼겹살 성수낙낙점,18,18,0,100.0,0.0
앳모스피어,18,16,2,88.9,11.1
성수찰순대국,17,17,0,100.0,0.0
돈앤돈 성수점,17,12,5,70.6,29.4
멜라 성수점,17,17,0,100.0,0.0
성수찌개,17,15,2,88.2,11.8
쉐프우,17,16,1,94.1,5.9
예바다,17,17,0,100.0,0.0
카페 포제,17,13,4,76.5,23.5
술래감자탕&순대국,17,16,1,94.1,5.9
미도림,17,14,3,82.4,17.6
나이스두잉 버거샵,17,17,0,100.0,0.0
아비꼬 성수역점,17,14,3,82.4,17.6
뜨리에이치,17,16,1,94.1,5.9
델리커리 성수낙낙점,17,17,0,100.0,0.0
하노이별 서울숲점,17,17,0,100.0,0.0
린,17,17,0,100.0,0.0
까까를로,17,17,0,100.0,0.0
파티세리후르츠,17,16,1,94.1,5.9
젤라또투유,17,16,1,94.1,5.9
동촌샤브칼국수,17,17,0,100.0,0.0
밥플러스 아이티캐슬점,17,15,2,88.2,11.8
묘사서울,17,17,0,100.0,0.0
레드브릭스모크하우스,17,17,0,100.0,0.0
바다화원 본점,17,17,0,100.0,0.0
스시현,17,17,0,100.0,0.0
진지방순대국,17,15,2,88.2,11.8
삽다리곱창,17,15,2,88.2,11.8
호미담,17,16,1,94.1,5.9
일호빵,17,17,0,100.0,0.0
왕짜장,17,17,0,100.0,0.0
꼬꼬스토리 성수점,17,17,0,100.0,0.0
KROW,16,15,1,93.8,6.2
플레이버타운,16,16,0,100.0,0.0
원산면옥,16,16,0,100.0,0.0
엉터리생고기 성수점,16,15,1,93.8,6.2
청주한씨,16,15,1,93.8,6.2
가장맛있는족발 뚝섬역점,16,12,4,75.0,25.0
작야,16,16,0,100.0,0.0
성수리얼,16,16,0,100.0,0.0
밀단지,16,16,0,100.0,0.0
오엔엘,16,16,0,100.0,0.0
토끼와거북전,16,15,1,93.8,6.2
찐짜솥뚜껑삼겹살갈비,16,16,0,100.0,0.0
현방오백소갈비살 성수점,16,16,0,100.0,0.0
육육면관,16,15,1,93.8,6.2
담소소사골순대육개장 성수시그마밸리점,16,15,1,93.8,6.2
본죽 뚝섬점,16,16,0,100.0,0.0
레스카페,16,16,0,100.0,0.0
행운식당,16,16,0,100.0,0.0
성수장,16,16,0,100.0,0.0
버터컵,15,15,0,100.0,0.0
포메인 서울숲점,15,14,1,93.3,6.7
찌마찌마,15,15,0,100.0,0.0
마구로쇼쿠도,15,15,0,100.0,0.0
숲떡,15,13,2,86.7,13.3
잭슨피자 성수점,15,15,0,100.0,0.0
커어피 & 젤라또,15,15,0,100.0,0.0
이곳에,15,12,3,80.0,20.0
열기,15,15,0,100.0,0.0
커피사피엔스 성수현대테라스점,15,15,0,100.0,0.0
원앤하프,15,13,2,86.7,13.3
향토칼국수,15,15,0,100.0,0.0
티케,15,15,0,100.0,0.0
마이쥬스 성수낙낙점,15,15,0,100.0,0.0
생활맥주 성수 한라시그마밸리점,15,15,0,100.0,0.0
독도사랑 막회,15,15,0,100.0,0.0
김밥천국 성수점,15,14,1,93.3,6.7
쿠시범,15,14,1,93.3,6.7
김가네김밥 성수시그마밸리점,15,15,0,100.0,0.0
매튜 Matthew,15,15,0,100.0,0.0
성수BONE 성수동한우짝갈비,15,15,0,100.0,0.0
아이오쓰리 성수사거리점,15,14,1,93.3,6.7
노을 1관,14,13,1,92.9,7.1
교대이층집 성수점,14,12,2,85.7,14.3
이우 다이닝,14,13,1,92.9,7.1
경성찹쌀꽈배기 뚝섬점,14,13,1,92.9,7.1
일미돼지국밥,14,13,1,92.9,7.1
삼원,14,14,0,100.0,0.0
이태리차차,14,14,0,100.0,0.0
올드너티 커피로스터스,14,14,0,100.0,0.0
오발탄 서울숲점,14,13,1,92.9,7.1
소문난성수감자탕,14,11,3,78.6,21.4
에이드티,14,14,0,100.0,0.0
순심이네생삼겹,14,14,0,100.0,0.0
숲속식사 철판볶음밥,14,12,2,85.7,14.3
뚝섬김밥,14,12,2,85.7,14.3
컴포즈커피 성수점,14,14,0,100.0,0.0
에이치커피로스터스,14,14,0,100.0,0.0
복닭 성수점,14,13,1,92.9,7.1
아카보시,14,13,1,92.9,7.1
문화공간 성수,14,14,0,100.0,0.0
자금성,14,14,0,100.0,0.0
피자스쿨 성수쇼핑센타점,14,13,1,92.9,7.1
장가,14,13,1,92.9,7.1
우리동네칼국수,14,14,0,100.0,0.0
더벤티 성수아이에스점,14,14,0,100.0,0.0
마포설농탕,14,14,0,100.0,0.0
노우노우바운즈,14,13,1,92.9,7.1
그믐족발 성수점,14,13,1,92.9,7.1
왕분식,14,14,0,100.0,0.0
파인와플,13,11,2,84.6,15.4
에이그레이트카페 성수점,13,12,1,92.3,7.7
누아흐,13,13,0,100.0,0.0
햄찌와베찌,13,13,0,100.0,0.0
성수물고기,13,13,0,100.0,0.0
서울숲오삼불고기,13,13,0,100.0,0.0
이안식당,13,12,1,92.3,7.7
한냄비,13,12,1,92.3,7.7
명가닭한마리,13,12,1,92.3,7.7
소소한가게,13,13,0,100.0,0.0
승리원,13,13,0,100.0,0.0
리브릭,13,13,0,100.0,0.0
포보스,13,13,0,100.0,0.0
서울맛집,13,12,1,92.3,7.7
싹쓰리곱창,13,13,0,100.0,0.0
피자인,13,13,0,100.0,0.0
리타르단도,13,13,0,100.0,0.0
글리머,13,13,0,100.0,0.0
땡초꼼장어,13,13,0,100.0,0.0
우야꼬칼국수파전,13,11,2,84.6,15.4
피읻짜,13,13,0,100.0,0.0
김밥 어때,13,13,0,100.0,0.0
푸라닭 성수1가점,13,13,0,100.0,0.0
윌리스엘에이피자,13,13,0,100.0,0.0
투그,13,13,0,100.0,0.0
독보,13,12,1,92.3,7.7
햄서울,13,12,1,92.3,7.7
60계치킨 서울성수점,13,13,0,100.0,0.0
송담추어탕 서울성수점,13,11,2,84.6,15.4
호랑도,13,13,0,100.0,0.0
헤이피자,13,13,0,100.0,0.0
또치 참숯생고기,13,13,0,100.0,0.0
코스모스상점,13,12,1,92.3,7.7
온슬,13,13,0,100.0,0.0
피리어드,13,13,0,100.0,0.0
텐바,13,13,0,100.0,0.0
은식당,13,12,1,92.3,7.7
셀렉토커피 서울숲IT캐슬점,13,12,1,92.3,7.7
죽변항,12,11,1,91.7,8.3
홍정원,12,11,1,91.7,8.3
풍년식당,12,11,1,91.7,8.3
BBQ치킨 성수2점,12,12,0,100.0,0.0
어부가,12,12,0,100.0,0.0
셀럽드샐러드,12,12,0,100.0,0.0
오아오아,12,12,0,100.0,0.0
프로가정식백반,12,12,0,100.0,0.0
커피기업 서울숲점,12,12,0,100.0,0.0
영화104,12,12,0,100.0,0.0
아재커피 성수2가점,12,11,1,91.7,8.3
제비뽑기,12,12,0,100.0,0.0
또래오래 성수점,12,12,0,100.0,0.0
웰컴차이나,12,11,1,91.7,8.3
비트랩,12,12,0,100.0,0.0
DODODO,12,12,0,100.0,0.0
박가부대 성수코오롱디지털밸리점,12,12,0,100.0,0.0
도토리편백집 이마트성수점,12,12,0,100.0,0.0
아끄떼 뚜,12,12,0,100.0,0.0
생활맥주 성수역1번출구점,12,9,3,75.0,25.0
모어,12,12,0,100.0,0.0
갈랭,12,12,0,100.0,0.0
에토프커피 성수,12,11,1,91.7,8.3
그레이박스,12,12,0,100.0,0.0
구시월닭한마리,12,10,2,83.3,16.7
맛차차,12,12,0,100.0,0.0
카페 스트랏,12,11,1,91.7,8.3
뱅글,12,12,0,100.0,0.0
성수 수집,11,10,1,90.9,9.1
장수숯불갈비,11,9,2,81.8,18.2
호칼국수 성수점,11,11,0,100.0,0.0
땅스부대찌개 성수점,11,9,2,81.8,18.2
송범순대국,11,11,0,100.0,0.0
한끼,11,11,0,100.0,0.0
호감도,11,10,1,90.9,9.1
네네치킨 성수2가점,11,11,0,100.0,0.0
도토루커피os,11,11,0,100.0,0.0
카페 투스프링,11,10,1,90.9,9.1
퍼니주,11,11,0,100.0,0.0
DYI WORKSHOP,11,11,0,100.0,0.0
신신원,11,11,0,100.0,0.0
부뚜막,11,9,2,81.8,18.2
전통씨래기국밥,11,11,0,100.0,0.0
밥플러스 성수에이팩센터점,11,11,0,100.0,0.0
피자헛 성수점,11,11,0,100.0,0.0
성수동꿀꽈배기,11,11,0,100.0,0.0
연탄요릿집,11,11,0,100.0,0.0
라스베이글 성수점,11,10,1,90.9,9.1
카페랏102,11,10,1,90.9,9.1
성운,11,10,1,90.9,9.1
해밀칼국수 성수점,11,11,0,100.0,0.0
댓길,11,11,0,100.0,0.0
페를 perle,11,10,1,90.9,9.1
도미노피자 서울숲점,11,10,1,90.9,9.1
이키나리돈부리,11,10,1,90.9,9.1
에보,11,11,0,100.0,0.0
교촌치킨 성수1호점,10,10,0,100.0,0.0
우디집,10,8,2,80.0,20.0
포미래,10,10,0,100.0,0.0
수향,10,10,0,100.0,0.0
다미,10,10,0,100.0,0.0
반가백암순대,10,10,0,100.0,0.0
맛닭꼬 뚝섬점,10,10,0,100.0,0.0
멜드,10,10,0,100.0,0.0
땡기면땡비어,10,9,1,90.0,10.0
이탈리안 누들,10,10,0,100.0,0.0
참나무로 바베큐,10,10,0,100.0,0.0
일월수제만두,10,10,0,100.0,0.0
맥스카나,10,10,0,100.0,0.0
오프커피,10,9,1,90.0,10.0
카페베네 성수점,10,10,0,100.0,0.0
왕십리정곱창 성수점,10,10,0,100.0,0.0
양평서울해장국큰아들집 성동세무서점,10,9,1,90.0,10.0
카페라니,10,10,0,100.0,0.0
오드비,10,10,0,100.0,0.0
룰루랄라 뚝섬역점,10,8,2,80.0,20.0
코너룸,10,10,0,100.0,0.0
사흘카레,10,10,0,100.0,0.0
아구보구,10,10,0,100.0,0.0
킴스치킨,10,9,1,90.0,10.0
뜸들이다 성수점,10,10,0,100.0,0.0
본,10,10,0,100.0,0.0
도쎄멕시칸,10,10,0,100.0,0.0
행운한식뷔페,10,10,0,100.0,0.0
하노이바게트,10,10,0,100.0,0.0
이흥부오향족발 뚝섬점,10,10,0,100.0,0.0
후프커피,10,9,1,90.0,10.0
암암리,10,10,0,100.0,0.0
오스테리아 로에로,10,10,0,100.0,0.0
청죽골 2호점,10,10,0,100.0,0.0
콜렉트,10,9,1,90.0,10.0
카페아모렘,10,10,0,100.0,0.0
한성식당,10,10,0,100.0,0.0
미각짬뽕양꼬치,10,10,0,100.0,0.0
노을 2관,10,10,0,100.0,0.0
프랑스포차,10,9,1,90.0,10.0
풍년정육점식당,10,10,0,100.0,0.0
윈야드 성수,10,10,0,100.0,0.0
무근본,10,8,2,80.0,20.0
EZER Coffee,10,8,2,80.0,20.0
슬로우캘리 뚝섬역점,10,10,0,100.0,0.0
곱씹어you,9,9,0,100.0,0.0
구스케이지,9,8,1,88.9,11.1
모멘토브루어스,9,9,0,100.0,0.0
독도참치 성수점,9,9,0,100.0,0.0
어글리크림치즈,9,9,0,100.0,0.0
얼룩,9,9,0,100.0,0.0
용짜장,9,9,0,100.0,0.0
그라데이션커피,9,9,0,100.0,0.0
케슬리 본점,9,9,0,100.0,0.0
신명먹거리,9,9,0,100.0,0.0
언커먼그라운드,9,9,0,100.0,0.0
외가집,9,9,0,100.0,0.0
더리터 성수역점,9,8,1,88.9,11.1
착한족발 성수점,9,9,0,100.0,0.0
피카워크샵,9,9,0,100.0,0.0
밥플러스 에이스하이엔드점,9,8,1,88.9,11.1
풍년숯불돼지갈비,9,9,0,100.0,0.0
신의주순대와쭈꾸미 성수점,9,7,2,77.8,22.2
언니커피,9,9,0,100.0,0.0
호루몬규상,9,9,0,100.0,0.0
커피베이 서울숲AK밸리점,9,9,0,100.0,0.0
커피사피엔스 선명스퀘어점,9,9,0,100.0,0.0
치카성수,9,9,0,100.0,0.0
자매집생선구이,9,9,0,100.0,0.0
프레이커피바 PCB서울,9,8,1,88.9,11.1
코시나,9,6,3,66.7,33.3
와규오감,9,9,0,100.0,0.0
호랑이식탁,9,9,0,100.0,0.0
글리터,9,9,0,100.0,0.0
나나횟집,9,8,1,88.9,11.1
춘천닭갈비,9,9,0,100.0,0.0
호식이두마리치킨 서울숲점,9,8,1,88.9,11.1
늘봄숯불갈비,9,9,0,100.0,0.0
다모토리혼,9,9,0,100.0,0.0
보난자 베이커리,9,9,0,100.0,0.0
장맛손칼국수,9,9,0,100.0,0.0
맞닿음 성수점,9,8,1,88.9,11.1
성수기,9,9,0,100.0,0.0
성수동 리얼 로스팅 커피&디저트,9,7,2,77.8,22.2
짬뽕타운,9,7,2,77.8,22.2
봉짬뽕,9,9,0,100.0,0.0
본말감자탕 뚝섬역점,9,8,1,88.9,11.1
카페바로,8,8,0,100.0,0.0
서울숲쭈꾸미,8,8,0,100.0,0.0
더존푸드,8,8,0,100.0,0.0
영식품,8,8,0,100.0,0.0
서울왕돈까스 성수점,8,7,1,87.5,12.5
신촌설렁탕,8,8,0,100.0,0.0
행복식당,8,8,0,100.0,0.0
과일파는 덕이언니,8,7,1,87.5,12.5
까칠이,8,8,0,100.0,0.0
퀸테트,8,8,0,100.0,0.0
호타루,8,8,0,100.0,0.0
플로이 FLOWY,8,8,0,100.0,0.0
bakery tomo,8,8,0,100.0,0.0
일루오리,8,8,0,100.0,0.0
B1 KITCHEN,8,8,0,100.0,0.0
커피베이 성동성수점,8,8,0,100.0,0.0
성수칼국수,8,7,1,87.5,12.5
다모아뷔페,8,8,0,100.0,0.0
빌런,8,8,0,100.0,0.0
흙과나무,8,8,0,100.0,0.0
앙골로에스프레소,8,8,0,100.0,0.0
온에떼라,8,8,0,100.0,0.0
티핀,8,7,1,87.5,12.5
어커,8,6,2,75.0,25.0
메쉬커피,8,8,0,100.0,0.0
송강제면소,8,7,1,87.5,12.5
오일장,8,8,0,100.0,0.0
하피,8,8,0,100.0,0.0
MYC CAFE,8,7,1,87.5,12.5
성수식당,8,7,1,87.5,12.5
포지티브 제로 라운지,8,5,3,62.5,37.5
한끼밥집,8,8,0,100.0,0.0
리커버리커피바,8,8,0,100.0,0.0
카페 스밍 스튜디오,8,7,1,87.5,12.5
태풍순대국,8,7,1,87.5,12.5
홍천숯닭,8,8,0,100.0,0.0
국일돼지왕갈비생삼겹살,8,8,0,100.0,0.0
리브나 Rivna,8,8,0,100.0,0.0
개성상인,8,8,0,100.0,0.0
밥플러스 6호점,8,8,0,100.0,0.0
파스쿠찌 서울숲점,8,7,1,87.5,12.5
범바,8,8,0,100.0,0.0
2002횟집,8,6,2,75.0,25.0
걸작떡볶이치킨 성수점,8,8,0,100.0,0.0
힘냉면록,8,8,0,100.0,0.0
예셰숄,7,7,0,100.0,0.0
온누리식당,7,7,0,100.0,0.0
5스타커피 셀렉트샵 서울숲점,7,7,0,100.0,0.0
빙맥홀닭 서울숲점,7,7,0,100.0,0.0
브레드온,7,7,0,100.0,0.0
오니기리와이규동 성수점,7,6,1,85.7,14.3
윤돈,7,7,0,100.0,0.0
김종욱 커피,7,6,1,85.7,14.3
IT 뷔페,7,7,0,100.0,0.0
두루치기김치찌개,7,6,1,85.7,14.3
고흥만,7,7,0,100.0,0.0
서울에스프레소,7,7,0,100.0,0.0
카페 차 성수점,7,7,0,100.0,0.0
Make,7,7,0,100.0,0.0
오비광장,7,7,0,100.0,0.0
윤스김밥,7,7,0,100.0,0.0
새촌식탁,7,7,0,100.0,0.0
베트남쌀국수,7,6,1,85.7,14.3
동맛골보쌈칼국수,7,7,0,100.0,0.0
생삼겹장수유황오리,7,7,0,100.0,0.0
원할머니보쌈족발 성수점,7,7,0,100.0,0.0
카페 뮤,7,6,1,85.7,14.3
309디저트카페,7,7,0,100.0,0.0
본가큰댁설렁탕 성수점,7,6,1,85.7,14.3
태양각,7,7,0,100.0,0.0
전통숯불꼼장어,7,7,0,100.0,0.0
조양생고기순대국,7,7,0,100.0,0.0
전주식당,7,6,1,85.7,14.3
프라이데이무브먼트,7,7,0,100.0,0.0
소안도풍경,7,6,1,85.7,14.3
SooLit,7,6,1,85.7,14.3
어페어커피,7,7,0,100.0,0.0
우리네밥상,7,7,0,100.0,0.0
죽고을,7,7,0,100.0,0.0
카페조이,7,7,0,100.0,0.0
맛닭꼬 성수뚝도점,7,7,0,100.0,0.0
시골집,7,6,1,85.7,14.3
곡성,7,7,0,100.0,0.0
백이의,7,7,0,100.0,0.0
쭈전부리,7,7,0,100.0,0.0
제로드,7,7,0,100.0,0.0
후다닭Q 본점,7,6,1,85.7,14.3
밤새우리,7,7,0,100.0,0.0
마누,7,7,0,100.0,0.0
와인쌤마켓 성수낙낙점,7,7,0,100.0,0.0
피터팬돈까스,7,7,0,100.0,0.0
르살롱오,7,7,0,100.0,0.0
뚝시돈,7,7,0,100.0,0.0
커피사피엔스 성수우림점,7,7,0,100.0,0.0
더다미,7,5,2,71.4,28.6
아이아이알,7,5,2,71.4,28.6
우리집밥,7,6,1,85.7,14.3
둘둘치킨 뚝섬점,7,7,0,100.0,0.0
pvglab,7,7,0,100.0,0.0
명동할머니국수 성수카페거리점,7,6,1,85.7,14.3
파라디,7,7,0,100.0,0.0
햄찌와베찌 뚝섬점,7,7,0,100.0,0.0
꼬꼬누리 성수이마트점,7,7,0,100.0,0.0
알디파트너스투자1호,7,6,1,85.7,14.3
쵸리상경,6,6,0,100.0,0.0
성수부엌,6,5,1,83.3,16.7
커피식탁,6,6,0,100.0,0.0
행닭바베큐통닭,6,6,0,100.0,0.0
유향소,6,6,0,100.0,0.0
큐씨오,6,6,0,100.0,0.0
뚝도지기,6,5,1,83.3,16.7
본도시락 성수점,6,6,0,100.0,0.0
제주올레포차 2호점,6,6,0,100.0,0.0
잇덴굿 성수점,6,6,0,100.0,0.0
파파존스 성수점,6,6,0,100.0,0.0
연탄구이집,6,6,0,100.0,0.0
참참치킨 성수점,6,6,0,100.0,0.0
비놈,6,6,0,100.0,0.0
에바스,6,6,0,100.0,0.0
서후와규,6,6,0,100.0,0.0
원조장충왕족발,6,6,0,100.0,0.0
압구정샌드위치 성수점,6,6,0,100.0,0.0
얼큰이왕냉면,6,6,0,100.0,0.0
성수손칼국수,6,6,0,100.0,0.0
옛날순대국밥,6,6,0,100.0,0.0
아웃오브타임,6,6,0,100.0,0.0
소시맥분,6,5,1,83.3,16.7
밀향기,6,6,0,100.0,0.0
뚝섬해물탕,6,6,0,100.0,0.0
우영푸드빌,6,6,0,100.0,0.0
푸라닭 성수2가점,6,6,0,100.0,0.0
소나무커피,6,5,1,83.3,16.7
엘라,6,6,0,100.0,0.0
맛보래,6,6,0,100.0,0.0
동신식당,6,5,1,83.3,16.7
넘버파이브,6,6,0,100.0,0.0
병천순대국 성수점,6,6,0,100.0,0.0
동강,6,5,1,83.3,16.7
수칼국수,6,6,0,100.0,0.0
뚝섬생고기,6,5,1,83.3,16.7
야페,6,6,0,100.0,0.0
오카보카,6,6,0,100.0,0.0
복식커피,6,6,0,100.0,0.0
하남돼지집 성수역점,6,6,0,100.0,0.0
성수골목,6,6,0,100.0,0.0
목로정원,6,6,0,100.0,0.0
대흥정육식당,6,5,1,83.3,16.7
그룬트,6,6,0,100.0,0.0
가내수공업고깃집,6,6,0,100.0,0.0
성수망치버거,6,5,1,83.3,16.7
커피덕후,6,6,0,100.0,0.0
per week,6,6,0,100.0,0.0
성수동골룸 서울숲 해산물 포장마차,6,6,0,100.0,0.0
페이지스,5,5,0,100.0,0.0
대돈집,5,5,0,100.0,0.0
성수족발,5,4,1,80.0,20.0
오프비트,5,5,0,100.0,0.0
레이어57 카페,5,5,0,100.0,0.0
알파카페,5,5,0,100.0,0.0
신성웰빙족발,5,5,0,100.0,0.0
인덱스카라멜,5,5,0,100.0,0.0
큰맘할매순대국 성수동점,5,5,0,100.0,0.0
뺌치킨,5,4,1,80.0,20.0
화로양미,5,5,0,100.0,0.0
황소미가,5,5,0,100.0,0.0
혜성분식,5,5,0,100.0,0.0
먹을만회,5,5,0,100.0,0.0
모루타루,5,4,1,80.0,20.0
제스티살룬성수,5,5,0,100.0,0.0
데이앤데이 뚝섬역점,5,5,0,100.0,0.0
청수먹거리,5,5,0,100.0,0.0
하이엔드라이,5,5,0,100.0,0.0
더킹돈 뚝섬점,5,5,0,100.0,0.0
장흥식당,5,5,0,100.0,0.0
심마니약초백숙,5,5,0,100.0,0.0
탕 김치찌개,5,5,0,100.0,0.0
잔치국수아줌마,5,5,0,100.0,0.0
베러로스팅랩&쇼룸,5,5,0,100.0,0.0
성수동꽈배기 로고스타,5,5,0,100.0,0.0
유메이규,5,4,1,80.0,20.0
삼선회사랑 뚝섬점,5,5,0,100.0,0.0
하루나,5,5,0,100.0,0.0
칠성옻닭,5,4,1,80.0,20.0
가마솥추어탕,5,5,0,100.0,0.0
시골가마솥삼겹살 성수점,5,4,1,80.0,20.0
물레방아민물매운탕,5,5,0,100.0,0.0
쿠켄치킨호프 성수점,5,4,1,80.0,20.0
벤투스커피 메가박스성수점,5,5,0,100.0,0.0
93밀리언마일즈,5,4,1,80.0,20.0
시장설렁탕,5,5,0,100.0,0.0
옴시롱 감시롱 순대국,5,4,1,80.0,20.0
음악창고 LP BAR,5,5,0,100.0,0.0
Cafe B&S,5,5,0,100.0,0.0
다담,5,5,0,100.0,0.0
넌 꼬막 난 육회,5,5,0,100.0,0.0
플라이팬커피 뚝섬점,5,5,0,100.0,0.0
싱싱횟집,5,4,1,80.0,20.0
에그마카슈 성수,5,5,0,100.0,0.0
솔솥성수점,4,3,1,75.0,25.0
디스코커피,4,4,0,100.0,0.0
오므오트,4,4,0,100.0,0.0
동호마을명태코다리,4,4,0,100.0,0.0
전주집,4,4,0,100.0,0.0
먼치스앤구디스,4,4,0,100.0,0.0
내추럴,4,4,0,100.0,0.0
이오커피로스터스,4,4,0,100.0,0.0
Salad No.6,4,4,0,100.0,0.0
중국관,4,4,0,100.0,0.0
CAFE FLARES,4,4,0,100.0,0.0
이지더즈잇,4,4,0,100.0,0.0
백야드빌더성수,4,4,0,100.0,0.0
로우커피스탠드 성수점,4,2,2,50.0,50.0
부경,4,4,0,100.0,0.0
별미식당,4,4,0,100.0,0.0
두남자의개수작,4,4,0,100.0,0.0
등심집,4,4,0,100.0,0.0
그린웰빙한식부페,4,4,0,100.0,0.0
시치미,4,3,1,75.0,25.0
도믹스,4,3,1,75.0,25.0
윤식당 한식뷔페,4,4,0,100.0,0.0
성수 팍스부대찌개 본점,4,4,0,100.0,0.0
모므로살롱,4,4,0,100.0,0.0
삼천만활어횟집,4,4,0,100.0,0.0
천수곱창,4,3,1,75.0,25.0
행운호프,4,4,0,100.0,0.0
커피코코,4,4,0,100.0,0.0
뚝도리보신탕,4,4,0,100.0,0.0
서산식당,4,3,1,75.0,25.0
투달러스커피,4,4,0,100.0,0.0
대성정,4,4,0,100.0,0.0
코코호도 성수점,4,4,0,100.0,0.0
레드이즈미,4,4,0,100.0,0.0
카페온유,4,4,0,100.0,0.0
피에스비 커피바,4,4,0,100.0,0.0
와인바킥,4,4,0,100.0,0.0
진수성찬한식뷔페,4,4,0,100.0,0.0
씨씨씨,4,4,0,100.0,0.0
논스톱샌드위치,4,4,0,100.0,0.0
원샷치킨,4,3,1,75.0,25.0
화랑직화구이,4,4,0,100.0,0.0
성수낙지,4,4,0,100.0,0.0
성수불타는곱창,4,4,0,100.0,0.0
투다리 뚝섬점,4,4,0,100.0,0.0
스시라온,4,4,0,100.0,0.0
내고향정육점식당,4,4,0,100.0,0.0
플록스,4,4,0,100.0,0.0
또와,4,4,0,100.0,0.0
앙심품은도야지,4,4,0,100.0,0.0
정참치,4,4,0,100.0,0.0
테이블 소사이어티 클럽,4,3,1,75.0,25.0
더블하이트 갤러리카페,4,4,0,100.0,0.0
BBQ치킨 성수3점,4,4,0,100.0,0.0
BHC치킨 성수역점,4,4,0,100.0,0.0
일정,4,4,0,100.0,0.0
빨간마초닭발 성수점,4,3,1,75.0,25.0
여기가좋겠네,4,4,0,100.0,0.0
피자파는집 서울성수점,4,4,0,100.0,0.0
YENA,4,2,2,50.0,50.0
마스,4,3,1,75.0,25.0
춘천닭갈비낙지철판,4,4,0,100.0,0.0
야끼도리정,4,3,1,75.0,25.0
한돈급냉삼겹살,4,4,0,100.0,0.0
성수뚝배기,4,4,0,100.0,0.0
아뜰리에 드 라 크레페,4,4,0,100.0,0.0
맥문동호프,3,3,0,100.0,0.0
맛부,3,3,0,100.0,0.0
태백집 성수점,3,3,0,100.0,0.0
유진참치,3,3,0,100.0,0.0
크레송,3,3,0,100.0,0.0
송가,3,3,0,100.0,0.0
박가객주,3,3,0,100.0,0.0
조리,3,3,0,100.0,0.0
남매칼국수,3,3,0,100.0,0.0
더키더키,3,2,1,66.7,33.3
밤토리,3,3,0,100.0,0.0
키보우 라멘,3,3,0,100.0,0.0
소적두 성수점,3,3,0,100.0,0.0
회현집,3,3,0,100.0,0.0
100회,3,3,0,100.0,0.0
미사랑,3,3,0,100.0,0.0
달님이네,3,3,0,100.0,0.0
담바골,3,3,0,100.0,0.0
카페크라비,3,3,0,100.0,0.0
둘둘치킨 성수1호점,3,2,1,66.7,33.3
카페일로,3,3,0,100.0,0.0
삼미냉면칼국수,3,2,1,66.7,33.3
성수스타우트,3,3,0,100.0,0.0
토프레소 성수우림점,3,3,0,100.0,0.0
릴레이션 카페,3,3,0,100.0,0.0
대박낙소 성수점,3,3,0,100.0,0.0
송계옥성수점,3,2,1,66.7,33.3
탕가네,3,3,0,100.0,0.0
LOWIDE,3,2,1,66.7,33.3
야곱293,3,3,0,100.0,0.0
세이버앤페이버,3,3,0,100.0,0.0
카페 알렛츠,3,3,0,100.0,0.0
현영이네,3,2,1,66.7,33.3
INDICA,3,3,0,100.0,0.0
제이엠,3,3,0,100.0,0.0
88켄터키 성수점,3,2,1,66.7,33.3
이삭토스트 성수2가점,3,3,0,100.0,0.0
찐미 숯불구이,3,3,0,100.0,0.0
최가네부대찌개,3,3,0,100.0,0.0
성수동양갈비,3,3,0,100.0,0.0
잇쇼우,3,3,0,100.0,0.0
dyscoffee,3,3,0,100.0,0.0
퀴바라,3,3,0,100.0,0.0
LAZZO,3,3,0,100.0,0.0
백리향중화요리,3,3,0,100.0,0.0
엑스익스프레스 성수낙낙점,3,3,0,100.0,0.0
미정이네식당,3,3,0,100.0,0.0
성수명당,3,3,0,100.0,0.0
브로벨커피,3,2,1,66.7,33.3
어촌횟집,3,3,0,100.0,0.0
모이크,3,3,0,100.0,0.0
미정이네코다리찜,3,3,0,100.0,0.0
파주부대찌개,3,3,0,100.0,0.0
리퀴드랩,3,3,0,100.0,0.0
스몰글라스,3,2,1,66.7,33.3
철규네분식,3,3,0,100.0,0.0
레타주,3,3,0,100.0,0.0
꽈배기에 반한 치킨 성수점,3,3,0,100.0,0.0
amado,2,2,0,100.0,0.0
카페온화 본사,2,2,0,100.0,0.0
뚝도수산,2,2,0,100.0,0.0
차만다서울숲점,2,2,0,100.0,0.0
영구스피자 성수점,2,2,0,100.0,0.0
한세희복집,2,2,0,100.0,0.0
훈이네,2,2,0,100.0,0.0
한남양옥 성수,2,2,0,100.0,0.0
뚝섬삼겹,2,2,0,100.0,0.0
백두대간 성수점,2,2,0,100.0,0.0
카나비스트릿,2,2,0,100.0,0.0
성수펍,2,2,0,100.0,0.0
제주뒷고기,2,2,0,100.0,0.0
센터커피,2,2,0,100.0,0.0
어랑횟집,2,2,0,100.0,0.0
소바짐,2,2,0,100.0,0.0
Kompakt Record Bar ver3,2,2,0,100.0,0.0
어썸브로시스,2,2,0,100.0,0.0
유니드카페,2,2,0,100.0,0.0
부덕관,2,2,0,100.0,0.0
성수숯불갈비,2,2,0,100.0,0.0
지수언니,2,2,0,100.0,0.0
피자스쿨 성수점,2,1,1,50.0,50.0
돼지맘,2,1,1,50.0,50.0
더블핸스테이크 서울숲점,2,2,0,100.0,0.0
더퍼즈,2,2,0,100.0,0.0
카페 마렐,2,2,0,100.0,0.0
바위파스타바 성수,2,2,0,100.0,0.0
쁘띠그랑,2,2,0,100.0,0.0
바탕,2,2,0,100.0,0.0
비스트로 앤드투투,2,2,0,100.0,0.0
모호인,2,2,0,100.0,0.0
지코바치킨 성수1호점,2,2,0,100.0,0.0
호남식당,2,2,0,100.0,0.0
라성키친,2,2,0,100.0,0.0
청진동해장국 성수점,2,2,0,100.0,0.0
쥬씨 성수IT점,2,2,0,100.0,0.0
제이앤제이펍,2,2,0,100.0,0.0
카페 메이,2,1,1,50.0,50.0
참숯나라갈비마을,2,2,0,100.0,0.0
밀도,2,1,1,50.0,50.0
글램 바,2,2,0,100.0,0.0
영계소문 옛날통닭,2,2,0,100.0,0.0
서울로인서울숲점,2,2,0,100.0,0.0
숙영이네,2,2,0,100.0,0.0
진미식당,2,2,0,100.0,0.0
문화식당,2,2,0,100.0,0.0
해리커피,2,2,0,100.0,0.0
서울앵무새,2,1,1,50.0,50.0
돼지네생삼겹살,2,2,0,100.0,0.0
몽련,2,2,0,100.0,0.0
중앙감속기,2,2,0,100.0,0.0
뚝도국수집,2,2,0,100.0,0.0
을지로골뱅이,2,2,0,100.0,0.0
한낮의밤,2,2,0,100.0,0.0
성수다락,2,2,0,100.0,0.0
종가빈대떡,2,2,0,100.0,0.0
황기닭한마리,2,2,0,100.0,0.0
카페리빈 성수점,2,2,0,100.0,0.0
봄의정원성수점,2,2,0,100.0,0.0
씨에이크,2,1,1,50.0,50.0
굴국밥현이네,2,2,0,100.0,0.0
화양리우동집,2,2,0,100.0,0.0
메종드마가레뜨,2,2,0,100.0,0.0
장위동유성집 성동점,1,1,0,100.0,0.0
우봉산수정,1,1,0,100.0,0.0
색다른면,1,1,0,100.0,0.0
호호식당,1,1,0,100.0,0.0
장안식당,1,1,0,100.0,0.0
대림창고,1,0,1,0.0,100.0
버거점프,1,1,0,100.0,0.0
완산골콩나물국밥,1,1,0,100.0,0.0
할아버지공장,1,1,0,100.0,0.0
십삼동,1,1,0,100.0,0.0
파치비 성수점,1,0,1,0.0,100.0
Naked Coffee,1,1,0,100.0,0.0
블루보틀성수점,1,1,0,100.0,0.0
RIN HOUSE,1,1,0,100.0,0.0
이야기가있는밥집,1,1,0,100.0,0.0
코끼리베이글성수,1,1,0,100.0,0.0
메이플탑,1,1,0,100.0,0.0
5to7,1,1,0,100.0,0.0
경수식당,1,1,0,100.0,0.0
우동가조쿠 성수점,1,1,0,100.0,0.0
윕성수,1,1,0,100.0,0.0
성수베이킹스튜디오,1,1,0,100.0,0.0
에르제,1,1,0,100.0,0.0
진작다이닝,1,1,0,100.0,0.0
멜로워,1,1,0,100.0,0.0
스트로베리32,1,1,0,100.0,0.0
소랑호젠,1,1,0,100.0,0.0
비사벌전주콩나물국밥,1,1,0,100.0,0.0
루덴스파트너스,1,1,0,100.0,0.0
코사이어티 서울숲,1,1,0,100.0,0.0
우오보파스타바,1,1,0,100.0,0.0
세스크멘슬,1,1,0,100.0,0.0
난포,1,1,0,100.0,0.0
온량,1,1,0,100.0,0.0
꽃나리분식,1,1,0,100.0,0.0
쓰리오브어스,1,1,0,100.0,0.0
어니언성수점,1,1,0,100.0,0.0
뿐또블루,1,1,0,100.0,0.0
인생낙곱새 성수점,1,1,0,100.0,0.0
광주식당,1,1,0,100.0,0.0
뵈르니,1,1,0,100.0,0.0
마포숫불갈비,1,1,0,100.0,0.0
Dii,1,1,0,100.0,0.0
시골옻닭,1,0,1,0.0,100.0
라일락,1,1,0,100.0,0.0
김사부코다리,1,1,0,100.0,0.0
배떡 성수점,1,1,0,100.0,0.0
삼삼이네생고기 성수점,1,1,0,100.0,0.0
초원,1,1,0,100.0,0.0
써니,1,1,0,100.0,0.0
또와포차,1,1,0,100.0,0.0
성수꼬마,1,1,0,100.0,0.0
지성식당,1,1,0,100.0,0.0
시골밥상,1,1,0,100.0,0.0
제비집,1,1,0,100.0,0.0
푸른바다횟집,1,1,0,100.0,0.0
양과자점 라보엠,1,1,0,100.0,0.0
낙타커피로스터스,1,1,0,100.0,0.0
락지,1,1,0,100.0,0.0
서래,1,1,0,100.0,0.0
뚝방생고기,1,1,0,100.0,0.0
백억포차,1,1,0,100.0,0.0
국동푸드 참엔고기,1,1,0,100.0,0.0
강남빈대떡,1,1,0,100.0,0.0
오늘도못참치,1,1,0,100.0,0.0
성수소파,1,1,0,100.0,0.0
민물집,1,1,0,100.0,0.0
제일,1,1,0,100.0,0.0
온더,1,1,0,100.0,0.0
카페오라,1,1,0,100.0,0.0
광순네식당,1,1,0,100.0,0.0
너랑나랑 콩나물국밥삼겹살,1,1,0,100.0,0.0
썬카페,1,1,0,100.0,0.0
울보분식,1,1,0,100.0,0.0
딤플맥주양주,1,1,0,100.0,0.0
슈퍼오리,1,1,0,100.0,0.0
앵무새루이스,1,0,1,0.0,100.0
금돼지,1,1,0,100.0,0.0
엄마네냄비밥,1,1,0,100.0,0.0
꾸이한끼 성수점,1,1,0,100.0,0.0
정든집,1,1,0,100.0,0.0
도슨트 성수,1,1,0,100.0,0.0
명인갈비 성수점,1,1,0,100.0,0.0
민티베리,1,1,0,100.0,0.0
스시모리,1,1,0,100.0,0.0
남경관,1,1,0,100.0,0.0
형제갈비,1,1,0,100.0,0.0
행복한 곱창,1,1,0,100.0,0.0
메모레,1,1,0,100.0,0.0
맛집이모네,1,1,0,100.0,0.0
오가네숯불곰장어,1,1,0,100.0,0.0
조디악,1,1,0,100.0,0.0
한강,1,1,0,100.0,0.0
성연순대국&족발,1,1,0,100.0,0.0
카페수다,1,1,0,100.0,0.0
두꺼비집,1,1,0,100.0,0.0
부성식당,1,1,0,100.0,0.0
성공is100,1,1,0,100.0,0.0
생태한마리,1,1,0,100.0,0.0
무등산닭한마리,1,1,0,100.0,0.0
전사랑,1,1,0,100.0,0.0
알천 성동본점,1,1,0,100.0,0.0
삼미식당,1,1,0,100.0,0.0
영동식당,1,1,0,100.0,0.0
55주막,1,1,0,100.0,0.0
