호텔,리뷰 개수,긍정 리뷰 개수,부정 리뷰 개수,긍정 리뷰 비율,부정 리뷰 비율
누데이크 성수점,182,167,15,91.8,8.2
노모어피자 서울숲점,182,177,5,97.3,2.7
문츠 바베큐,154,145,9,94.2,5.8
포도젝트,152,151,1,99.3,0.7
티룸,146,145,1,99.3,0.7
인치스,140,138,2,98.6,1.4
카멜커피 7호점,131,121,10,92.4,7.6
시즈니,119,119,0,100.0,0.0
보마켓 서울숲점,119,113,6,95.0,5.0
동빙고 성수점,116,106,10,91.4,8.6
크림라벨 서울숲 본점,114,111,3,97.4,2.6
젠젠 성수점,111,107,4,96.4,3.6
계모임,110,110,0,100.0,0.0
메종 파이프그라운드,110,106,4,96.4,3.6
스케줄 성수,109,103,6,94.5,5.5
오프트,108,107,1,99.1,0.9
캐스터네츠 서울숲점,108,106,2,98.1,1.9
앤드밀 성수점,104,100,4,96.2,3.8
고집132 성수본점,98,93,5,94.9,5.1
팔각도 성수역점,97,93,4,95.9,4.1
연남토마 성수점,96,90,6,93.8,6.2
서울바나나,93,89,4,95.7,4.3
파티세리 아모니,93,93,0,100.0,0.0
파머스카페,92,90,2,97.8,2.2
성수온실,90,89,1,98.9,1.1
망티커피 성수점,89,85,4,95.5,4.5
굿갓레스토랑 성수역점,86,86,0,100.0,0.0
후라토식당 성수점,86,83,3,96.5,3.5
이오로비스트로,86,82,4,95.3,4.7
로우키,83,75,8,90.4,9.6
훈연,83,78,5,94.0,6.0
테디스오븐,82,77,5,93.9,6.1
다포케 성수점,81,77,4,95.1,4.9
윤경양식당,79,74,5,93.7,6.3
만학,79,71,8,89.9,10.1
폴인레미유 성수점,78,77,1,98.7,1.3
르프리크,78,74,4,94.9,5.1
보끔당 성수점,77,77,0,100.0,0.0
소인수서울 본점,76,76,0,100.0,0.0
슈퍼말차 성수,76,72,4,94.7,5.3
가조쿠,75,72,3,96.0,4.0
미도인 성수,75,68,7,90.7,9.3
세디치,75,74,1,98.7,1.3
밸런스포케 서울숲점,74,70,4,94.6,5.4
권식족발 성수본점,74,72,2,97.3,2.7
천하제일 솥뚜껑,74,71,3,95.9,4.1
퍼먼트,74,67,7,90.5,9.5
쎈느Scene,73,70,3,95.9,4.1
로우커피스탠드,73,71,2,97.3,2.7
르셀,73,72,1,98.6,1.4
까망,72,72,0,100.0,0.0
테니,71,66,5,93.0,7.0
누메로도스,69,66,3,95.7,4.3
오늘와인한잔 성수가든점,69,67,2,97.1,2.9
다운타우너 성수 피치스,68,67,1,98.5,1.5
메가MGC커피 서울숲역점,68,63,5,92.6,7.4
피키니키 라자냐,67,65,2,97.0,3.0
훔볼트,67,63,4,94.0,6.0
bd버거 성수,65,63,2,96.9,3.1
맘스터치 성수역점,65,60,5,92.3,7.7
성수노루,65,64,1,98.5,1.5
써브웨이 성수역점,64,57,7,89.1,10.9
한음,64,63,1,98.4,1.6
대성갈비,64,56,8,87.5,12.5
메가MGC커피 성수일로점,63,58,5,92.1,7.9
천상가옥,63,61,2,96.8,3.2
쎄콩데live,62,59,3,95.2,4.8
파티세리후르츠,62,59,3,95.2,4.8
성수삐딱,62,55,7,88.7,11.3
니드스윗,62,62,0,100.0,0.0
달래해장 성수점,61,50,11,82.0,18.0
목금,61,59,2,96.7,3.3
하이라인,61,61,0,100.0,0.0
푸드갤러리빈,60,59,1,98.3,1.7
노가리마켓 서울숲,60,53,7,88.3,11.7
차일디쉬,59,57,2,96.6,3.4
럭럭카페,59,58,1,98.3,1.7
바이레인,59,59,0,100.0,0.0
베티버 성수,58,55,3,94.8,5.2
오우드 성수1호점,58,56,2,96.6,3.4
성수이루다,58,58,0,100.0,0.0
밥밥디라라 뚝섬역점,58,57,1,98.3,1.7
하프커피 성수,58,55,3,94.8,5.2
무브모브 성수,57,57,0,100.0,0.0
레이더,57,53,4,93.0,7.0
리얼월드 성수,56,56,0,100.0,0.0
아울림,56,56,0,100.0,0.0
브라운래빗 서울숲점,56,50,6,89.3,10.7
해밀칼국수&김밥,56,53,3,94.6,5.4
할머니의 레시피,56,54,2,96.4,3.6
라프레플루트,55,54,1,98.2,1.8
뚝도농원,55,48,7,87.3,12.7
까치화방 성수낙낙점,55,53,2,96.4,3.6
꿉당 성수점,55,50,5,90.9,9.1
비스트로성수,54,54,0,100.0,0.0
카린지_린가네 스낵바,54,53,1,98.1,1.9
서울숲누룽지통닭구이,53,48,5,90.6,9.4
루디먼트,53,52,1,98.1,1.9
위드번,53,52,1,98.1,1.9
강남면옥 성수점,53,51,2,96.2,3.8
잠수교집 성수 직영점,53,52,1,98.1,1.9
멘야코노하 성수,53,53,0,100.0,0.0
쿠나,53,51,2,96.2,3.8
도렐 성수점,53,49,4,92.5,7.5
화화담 성수,53,52,1,98.1,1.9
페이퍼 플레이트,52,50,2,96.2,3.8
시옹마오,52,50,2,96.2,3.8
오레노카츠 성수본점,52,49,3,94.2,5.8
훼미리손칼국수보쌈,51,47,4,92.2,7.8
롯데리아 성수역점,51,49,2,96.1,3.9
투썸플레이스 성수skv타워점,51,49,2,96.1,3.9
에이셉피자 성수점,51,49,2,96.1,3.9
올댓커피 포레스트점,50,50,0,100.0,0.0
어메이징브루잉컴퍼니,50,48,2,96.0,4.0
파르코,50,48,2,96.0,4.0
소바식당,49,44,5,89.8,10.2
도도한면 성수본점,49,47,2,95.9,4.1
왕삼겹정육식당,49,49,0,100.0,0.0
래뮤,48,45,3,93.8,6.2
희릿,47,45,2,95.7,4.3
팜티진쌀국수,47,46,1,97.9,2.1
누아흐,47,47,0,100.0,0.0
제제,46,43,3,93.5,6.5
감도 성수점,46,45,1,97.8,2.2
헤비스테이크 성수점,46,44,2,95.7,4.3
성수옥아궁지 성수본점,45,45,0,100.0,0.0
샐러디 성수점,45,42,3,93.3,6.7
홍화돈,45,41,4,91.1,8.9
마하차이 성수본점,45,39,6,86.7,13.3
기후,45,45,0,100.0,0.0
미쁘동 서울숲,44,44,0,100.0,0.0
모모야 성수점,44,42,2,95.5,4.5
stdo,44,43,1,97.7,2.3
신라다랑원 성수점,44,42,2,95.5,4.5
지우관,44,44,0,100.0,0.0
디플랫 성수,43,40,3,93.0,7.0
빙맥홀닭 서울숲점,43,42,1,97.7,2.3
라에비뉴,43,43,0,100.0,0.0
중화카츠 서울숲,43,43,0,100.0,0.0
미아논나,42,40,2,95.2,4.8
캐주얼성수,42,42,0,100.0,0.0
비파서울,42,40,2,95.2,4.8
버섯집,42,42,0,100.0,0.0
탄스이카부츠,41,38,3,92.7,7.3
신사동 벼락집,41,41,0,100.0,0.0
아이오쓰리 에이스하이엔드점,41,41,0,100.0,0.0
푸르너스가든 서울숲,41,38,3,92.7,7.3
유어네이키드치즈,41,38,3,92.7,7.3
체다앤올리,41,39,2,95.1,4.9
당도,40,36,4,90.0,10.0
포배럴카페,40,35,5,87.5,12.5
마하차이 서울숲점,40,39,1,97.5,2.5
꽌코이,40,40,0,100.0,0.0
일일향 성수10호점,40,34,6,85.0,15.0
메시,40,40,0,100.0,0.0
201호,39,39,0,100.0,0.0
오늘애김밥 성수역점,39,39,0,100.0,0.0
웜히어,39,39,0,100.0,0.0
정선부뚜막,39,34,5,87.2,12.8
화이트글래스,39,39,0,100.0,0.0
이곳에,39,38,1,97.4,2.6
마블상회,39,39,0,100.0,0.0
성수옥상,39,38,1,97.4,2.6
원기옥,39,37,2,94.9,5.1
버거보이 성수낙낙점,38,31,7,81.6,18.4
롸카두들 내쉬빌 핫치킨 성수점,38,36,2,94.7,5.3
금금 성수점,38,37,1,97.4,2.6
빠오즈푸 서울숲직영점,38,37,1,97.4,2.6
유스트레스,38,37,1,97.4,2.6
컴포즈커피 화양사거리점,38,38,0,100.0,0.0
대낚식당,38,36,2,94.7,5.3
미디엄스톤 성수점,37,37,0,100.0,0.0
하늘분식,37,37,0,100.0,0.0
카멜커피 성수점,37,35,2,94.6,5.4
공차 서울숲점,37,36,1,97.3,2.7
매머드익스프레스 성수역SKV1점,37,35,2,94.6,5.4
성수김밥 퍼니텅,37,36,1,97.3,2.7
오우도,37,37,0,100.0,0.0
매머드익스프레스 성수역점,37,37,0,100.0,0.0
마리오네,37,37,0,100.0,0.0
사람사는 고깃집 김일도 성수점,36,35,1,97.2,2.8
카페요아정,36,35,1,97.2,2.8
빽다방 뚝섬역점,36,36,0,100.0,0.0
구욱희씨 서울숲점,36,34,2,94.4,5.6
프롤라,36,35,1,97.2,2.8
글로우,36,33,3,91.7,8.3
스텀필즈커피,35,35,0,100.0,0.0
소바마에,35,35,0,100.0,0.0
포동푸딩,35,35,0,100.0,0.0
빽다방 성수역롯데캐슬점,35,35,0,100.0,0.0
산들김밥,35,34,1,97.1,2.9
코치,35,31,4,88.6,11.4
평이담백뼈칼국수 성수점,35,34,1,97.1,2.9
성수우동,35,34,1,97.1,2.9
FINZ 핀즈,35,31,4,88.6,11.4
벱,35,33,2,94.3,5.7
어퍼룸,35,35,0,100.0,0.0
뚜르띠에르,35,34,1,97.1,2.9
BNHR,35,33,2,94.3,5.7
구아바,35,35,0,100.0,0.0
벨라스가든 서울숲점,35,33,2,94.3,5.7
성수맥주,35,30,5,85.7,14.3
피자니스타 서울숲점,34,32,2,94.1,5.9
에피타이트,34,33,1,97.1,2.9
버니타운,34,33,1,97.1,2.9
글레이셔박,34,32,2,94.1,5.9
멘야마쯔리 성수점,34,33,1,97.1,2.9
정돈 성수점,34,34,0,100.0,0.0
무식당 성수본점,34,28,6,82.4,17.6
일구공 성수 본점,34,34,0,100.0,0.0
크리스탈드래곤 성수낙낙점,33,31,2,93.9,6.1
홍콩반점0410 성수역점,33,32,1,97.0,3.0
기러기둥지 성수,33,31,2,93.9,6.1
호랑이 초밥,33,32,1,97.0,3.0
탕화쿵푸마라탕 성수동지점,33,33,0,100.0,0.0
성수로운,33,32,1,97.0,3.0
기미사 성수,33,33,0,100.0,0.0
필살기CAFE,33,33,0,100.0,0.0
도죠,33,30,3,90.9,9.1
소년식당,33,32,1,97.0,3.0
반포식스 성수점,33,30,3,90.9,9.1
신선식탁 성수역점,33,33,0,100.0,0.0
더카페 서울숲역점,33,33,0,100.0,0.0
스시메이 성수점,33,32,1,97.0,3.0
퀴버 서울숲,33,33,0,100.0,0.0
공차 성수역점,32,32,0,100.0,0.0
우시야 성수점,32,32,0,100.0,0.0
뚝 다이닝,32,31,1,96.9,3.1
BELOW SEONGSOO,32,32,0,100.0,0.0
바르다김선생 서울숲점,32,29,3,90.6,9.4
라비옹카페,32,30,2,93.8,6.2
에이투비 Cafe&Bar,32,30,2,93.8,6.2
유가츠,32,31,1,96.9,3.1
춘하추우동,32,30,2,93.8,6.2
타크,31,30,1,96.8,3.2
백정돈공장,31,30,1,96.8,3.2
오스테리아 파로,31,31,0,100.0,0.0
스시오오모토,31,29,2,93.5,6.5
라온석갈비,31,30,1,96.8,3.2
스테치,30,30,0,100.0,0.0
우웨이탕,30,30,0,100.0,0.0
봉쥬르,30,29,1,96.7,3.3
빽다방 화양사거리점,30,28,2,93.3,6.7
성수시루,30,30,0,100.0,0.0
차이나플레인 서울숲점,30,30,0,100.0,0.0
술있는식탁,30,30,0,100.0,0.0
24시전주명가콩나물국밥 서울성수점,30,30,0,100.0,0.0
밋보어 카페 & 이터리 by 에디션덴마크,30,30,0,100.0,0.0
그리너 성수1가점,30,25,5,83.3,16.7
이가네양꼬치 성수직영점,30,29,1,96.7,3.3
누메로뜨레쓰,30,30,0,100.0,0.0
화랑직화구이,29,29,0,100.0,0.0
타코마이너,29,29,0,100.0,0.0
한촌설렁탕 성수뚝도점,29,29,0,100.0,0.0
쿠키샾,29,29,0,100.0,0.0
그린랩,29,29,0,100.0,0.0
젤라또투유,29,29,0,100.0,0.0
포어플랜,29,25,4,86.2,13.8
ONE BEAN카페,29,29,0,100.0,0.0
Pauline CoffeeBar,29,29,0,100.0,0.0
성수부두,29,29,0,100.0,0.0
온센 성수점,29,26,3,89.7,10.3
나누리잡화점,29,29,0,100.0,0.0
본노엘 성수점,28,27,1,96.4,3.6
고운 돈카츠,28,27,1,96.4,3.6
컴오프,28,27,1,96.4,3.6
KROW,28,28,0,100.0,0.0
비스트로류,28,28,0,100.0,0.0
북촌손만두 성수역점,28,26,2,92.9,7.1
모어,28,26,2,92.9,7.1
발렁스,28,28,0,100.0,0.0
업사이드커피,28,26,2,92.9,7.1
부우이,28,28,0,100.0,0.0
르베지왕 성수공간,27,23,4,85.2,14.8
등촌샤브칼국수 성수점,27,23,4,85.2,14.8
화포식당성수,27,27,0,100.0,0.0
성수오오,27,27,0,100.0,0.0
윤경,27,25,2,92.6,7.4
뚜레쥬르 성수역점,27,25,2,92.6,7.4
성수물고기,27,27,0,100.0,0.0
엘더버거,27,26,1,96.3,3.7
아웃오브타임,27,27,0,100.0,0.0
호감도,27,26,1,96.3,3.7
써브웨이 서울숲점,27,24,3,88.9,11.1
에토프커피 성수,27,27,0,100.0,0.0
전자방,27,27,0,100.0,0.0
카페&펍 연무장,26,24,2,92.3,7.7
슈에뜨펍,26,26,0,100.0,0.0
힘이나는커피생활 성수2호점,26,25,1,96.2,3.8
까까를로,26,25,1,96.2,3.8
하오마라,26,24,2,92.3,7.7
심야의 숲,26,26,0,100.0,0.0
칼,26,26,0,100.0,0.0
힘이나는커피생활 성수3호점,26,25,1,96.2,3.8
오와리 본점,26,23,3,88.5,11.5
우마텐 텐동,26,21,5,80.8,19.2
보스코 에스프레소 바,26,25,1,96.2,3.8
아키야마,26,26,0,100.0,0.0
야드 서울,26,25,1,96.2,3.8
올로,26,26,0,100.0,0.0
"여기 런던 Here, london",26,25,1,96.2,3.8
포맨스,26,24,2,92.3,7.7
마크69,25,23,2,92.0,8.0
어라운드데이,25,24,1,96.0,4.0
짬뽕위에더짬뽕,25,24,1,96.0,4.0
미오 도쿄 다이닝,25,24,1,96.0,4.0
회사식당,25,25,0,100.0,0.0
타논55,25,24,1,96.0,4.0
칙피스 성수점,25,23,2,92.0,8.0
누에종,25,25,0,100.0,0.0
열기,25,24,1,96.0,4.0
토라식당,24,19,5,79.2,20.8
백이의,24,24,0,100.0,0.0
경성찹쌀꽈배기 성수역점,24,23,1,95.8,4.2
아구보구,24,24,0,100.0,0.0
고공 성수본점,24,24,0,100.0,0.0
DYI WORKSHOP,24,24,0,100.0,0.0
청정옥,24,24,0,100.0,0.0
마르코웤스,24,24,0,100.0,0.0
성수불타는곱창,24,24,0,100.0,0.0
위키드와이프,23,23,0,100.0,0.0
HDD피자,23,18,5,78.3,21.7
마봉양꼬치 성수점,23,23,0,100.0,0.0
멜드,23,23,0,100.0,0.0
록멘,23,23,0,100.0,0.0
울림,23,20,3,87.0,13.0
더벤티 성수카페거리점,23,22,1,95.7,4.3
토리아에즈,23,22,1,95.7,4.3
써니브레드,23,21,2,91.3,8.7
윌리스엘에이피자,23,23,0,100.0,0.0
스시포레,23,23,0,100.0,0.0
청담순대국,23,23,0,100.0,0.0
힘냉면록,22,22,0,100.0,0.0
밀카페 우프,22,22,0,100.0,0.0
계월 곰탕,22,21,1,95.5,4.5
단일서울,22,22,0,100.0,0.0
비트랩,22,22,0,100.0,0.0
저스트텐동 성수점,22,22,0,100.0,0.0
포메인 서울숲점,22,22,0,100.0,0.0
그믐족발 성수점,22,22,0,100.0,0.0
꼬치상점,22,21,1,95.5,4.5
천미향,22,20,2,90.9,9.1
가가호호 성수점,22,21,1,95.5,4.5
오버도즈도넛앤커피,22,21,1,95.5,4.5
성수초밥 성수점,22,22,0,100.0,0.0
부산밀면,22,22,0,100.0,0.0
뚝섬포구,22,22,0,100.0,0.0
오토김밥 서울숲점,22,21,1,95.5,4.5
생활맥주 성수 한라시그마밸리점,22,20,2,90.9,9.1
땅스부대찌개 성수점,21,21,0,100.0,0.0
아타리,21,20,1,95.2,4.8
빙봉,21,16,5,76.2,23.8
에이그레이트카페 성수점,21,19,2,90.5,9.5
세븐갈비,21,17,4,81.0,19.0
글리머,21,20,1,95.2,4.8
성수속향연,21,19,2,90.5,9.5
MYC CAFE,21,20,1,95.2,4.8
강다짐 삼각김밥 성수점,21,18,3,85.7,14.3
델리커리 성수낙낙점,21,20,1,95.2,4.8
스시이치바,21,21,0,100.0,0.0
육품,21,21,0,100.0,0.0
동구식당,21,21,0,100.0,0.0
강남교자 뚝섬역점,21,19,2,90.5,9.5
마씨,21,20,1,95.2,4.8
키베이커리,20,19,1,95.0,5.0
팩피,20,18,2,90.0,10.0
신의한국수본점,20,19,1,95.0,5.0
담미온 성수점,20,18,2,90.0,10.0
라무진 성수카페거리점,20,17,3,85.0,15.0
산내골칼국수,20,19,1,95.0,5.0
티케,20,19,1,95.0,5.0
카페 스밍 스튜디오,20,19,1,95.0,5.0
무근본,20,18,2,90.0,10.0
성수아구찜,20,20,0,100.0,0.0
오근내7닭갈비,20,19,1,95.0,5.0
구펠,20,20,0,100.0,0.0
벤투스커피 메가박스성수점,20,19,1,95.0,5.0
dyscoffee,20,20,0,100.0,0.0
녹마이,20,20,0,100.0,0.0
도담순대국 성수본점,20,19,1,95.0,5.0
민정식당 서울숲 직영점,20,19,1,95.0,5.0
커피기업 서울숲점,20,20,0,100.0,0.0
포지티브 서울숲,20,20,0,100.0,0.0
마구로쇼쿠도,20,19,1,95.0,5.0
청춘고깃간,20,18,2,90.0,10.0
수원원조갈비,20,18,2,90.0,10.0
빽다방 성수뚝도점,20,20,0,100.0,0.0
연탄불꼼장어,19,19,0,100.0,0.0
퀸테트,19,19,0,100.0,0.0
리틀포레스트,19,19,0,100.0,0.0
해피캔디쿠키,19,19,0,100.0,0.0
남다른본가닭한마리 성수점,19,19,0,100.0,0.0
동대문엽기떡볶이 성수점,19,18,1,94.7,5.3
이로우,19,18,1,94.7,5.3
넌 꼬막 난 육회,19,19,0,100.0,0.0
이안식당,19,19,0,100.0,0.0
성수피글렛,19,19,0,100.0,0.0
소적두 성수점,19,18,1,94.7,5.3
사운드 플래닛,19,19,0,100.0,0.0
오엔엘,19,19,0,100.0,0.0
라무진 성수점,19,17,2,89.5,10.5
카페 차 성수점,19,18,1,94.7,5.3
바다화원 본점,19,19,0,100.0,0.0
매머드익스프레스 성수우림점,19,19,0,100.0,0.0
샹도르본사직영점,19,19,0,100.0,0.0
독도사랑 막회,19,18,1,94.7,5.3
진짜배기명태촌 서울성수점,19,19,0,100.0,0.0
카페베네 성수점,19,18,1,94.7,5.3
홍보석,19,19,0,100.0,0.0
조개도,19,19,0,100.0,0.0
보이어,19,19,0,100.0,0.0
퍼틴 성수점,19,17,2,89.5,10.5
민속김밥,18,18,0,100.0,0.0
파리바게뜨 성수코오롱점,18,18,0,100.0,0.0
이북집 찹쌀순대 성수점,18,17,1,94.4,5.6
노이,18,17,1,94.4,5.6
풍조미역 성수본점,18,18,0,100.0,0.0
싹쓰리곱창,18,18,0,100.0,0.0
송흥,18,18,0,100.0,0.0
착한짜장,18,17,1,94.4,5.6
퍼니주,18,17,1,94.4,5.6
nothingmatters,18,17,1,94.4,5.6
시원,18,17,1,94.4,5.6
원산면옥,18,15,3,83.3,16.7
작야,18,18,0,100.0,0.0
뚝섬숯불갈비,18,15,3,83.3,16.7
도토리편백집 이마트성수점,18,16,2,88.9,11.1
피자시즌,18,17,1,94.4,5.6
란돌프서울숲,18,17,1,94.4,5.6
앳모스피어,17,17,0,100.0,0.0
리타르단도,17,17,0,100.0,0.0
일심정,17,17,0,100.0,0.0
세광양대창 성수점,17,13,4,76.5,23.5
용이네,17,17,0,100.0,0.0
방춘리,17,17,0,100.0,0.0
엘레멘츠,17,17,0,100.0,0.0
은빛물결 황금낙지,17,17,0,100.0,0.0
매튜 Matthew,17,17,0,100.0,0.0
더즌오이스터 성수,17,17,0,100.0,0.0
플레이버타운,17,14,3,82.4,17.6
호호반점 성수낙낙점,17,15,2,88.2,11.8
광장족발 본가,17,17,0,100.0,0.0
바오 서울,17,15,2,88.2,11.8
카페 포제,17,16,1,94.1,5.9
오시요거트,17,17,0,100.0,0.0
송담추어탕 서울성수점,17,16,1,94.1,5.9
아니마토,17,17,0,100.0,0.0
성수면당,17,16,1,94.1,5.9
엉터리생고기 성수점,17,17,0,100.0,0.0
제비뽑기,17,16,1,94.1,5.9
황금어장,17,16,1,94.1,5.9
꼬꼬스토리 성수점,17,17,0,100.0,0.0
이태리차차,17,17,0,100.0,0.0
위스위츠,17,17,0,100.0,0.0
히즈빈스 성수점,17,17,0,100.0,0.0
아비꼬 성수역점,17,15,2,88.2,11.8
갈랭,17,17,0,100.0,0.0
아이오쓰리 성수사거리점,16,15,1,93.8,6.2
써니눅,16,16,0,100.0,0.0
빅쭌부대찌개 성수점,16,15,1,93.8,6.2
미락바지락칼국수,16,16,0,100.0,0.0
곳온니플레이스 성수낙낙,16,16,0,100.0,0.0
탐앤탐스 성수1호점,16,15,1,93.8,6.2
프랑스포차,16,16,0,100.0,0.0
성수일미락,16,14,2,87.5,12.5
현방오백소갈비살 성수점,16,15,1,93.8,6.2
짬뽕품격,16,15,1,93.8,6.2
김밥천국 서울숲점,16,16,0,100.0,0.0
페스티발,16,16,0,100.0,0.0
브루잉 세레모니,16,14,2,87.5,12.5
하노이102,16,16,0,100.0,0.0
삽다리곱창,16,16,0,100.0,0.0
역전할머니맥주 성수점,16,16,0,100.0,0.0
명가닭한마리,16,15,1,93.8,6.2
강호연파 성수 숲속산장점,16,14,2,87.5,12.5
리옹베이커리,16,16,0,100.0,0.0
도치피자 성수,16,16,0,100.0,0.0
마루제면소,16,15,1,93.8,6.2
매머드익스프레스 뚝섬역점,16,14,2,87.5,12.5
이랑칼국수,16,16,0,100.0,0.0
밀본 본점,15,14,1,93.3,6.7
담소소사골순대육개장 서울숲점,15,15,0,100.0,0.0
르살롱오,15,15,0,100.0,0.0
도쎄멕시칸,15,15,0,100.0,0.0
술래감자탕&순대국,15,15,0,100.0,0.0
퍼응언쌀국수,15,13,2,86.7,13.3
명국수,15,15,0,100.0,0.0
이삭토스트 성수2가점,15,15,0,100.0,0.0
문득,15,15,0,100.0,0.0
멜라 성수점,15,15,0,100.0,0.0
예빈당,15,15,0,100.0,0.0
새촌식탁,15,15,0,100.0,0.0
효자동목고기,15,15,0,100.0,0.0
하노이별 서울숲점,15,15,0,100.0,0.0
아재커피 성수2가점,15,15,0,100.0,0.0
성수닭발,15,15,0,100.0,0.0
커피스미스,15,12,3,80.0,20.0
스시류블랙 성수낙낙점,14,14,0,100.0,0.0
스시현,14,14,0,100.0,0.0
어묵나라,14,13,1,92.9,7.1
웨이크앤베이크 성수,14,13,1,92.9,7.1
타이거풀,14,13,1,92.9,7.1
스탠드업플리즈바이턴온,14,13,1,92.9,7.1
코코호도 성수점,14,14,0,100.0,0.0
소시맥분,14,12,2,85.7,14.3
아오미,14,12,2,85.7,14.3
왕십리정곱창 성수점,14,14,0,100.0,0.0
호미담,14,14,0,100.0,0.0
카페조이,14,13,1,92.9,7.1
샵아지트,14,14,0,100.0,0.0
수향,14,14,0,100.0,0.0
피읻짜,14,14,0,100.0,0.0
반상회 성수,14,12,2,85.7,14.3
노랑통닭 성수점,14,13,1,92.9,7.1
오아오아,14,14,0,100.0,0.0
노을 2관,14,13,1,92.9,7.1
오부대찌개,14,14,0,100.0,0.0
패티패티,14,14,0,100.0,0.0
성수리얼,14,14,0,100.0,0.0
노을 1관,14,13,1,92.9,7.1
쉐프우,14,14,0,100.0,0.0
제일 참 순대국,14,14,0,100.0,0.0
그라데이션커피,14,14,0,100.0,0.0
뚝배기양평해장국 성수점,14,14,0,100.0,0.0
또와,14,14,0,100.0,0.0
묘사서울,14,13,1,92.9,7.1
후라이드참잘하는집 성수점,14,14,0,100.0,0.0
범바,14,14,0,100.0,0.0
숲떡,14,12,2,85.7,14.3
텐바,14,13,1,92.9,7.1
한냄비,13,12,1,92.3,7.7
굴림,13,13,0,100.0,0.0
승리원,13,13,0,100.0,0.0
퓨엘커피,13,13,0,100.0,0.0
푸라닭 성수1가점,13,13,0,100.0,0.0
달구벌반점,13,12,1,92.3,7.7
오프커피,13,13,0,100.0,0.0
다로베,13,13,0,100.0,0.0
플래닝샐러드,13,11,2,84.6,15.4
에보,13,13,0,100.0,0.0
댓길,13,12,1,92.3,7.7
파인와플,13,13,0,100.0,0.0
덕,13,12,1,92.3,7.7
칠칠칠,13,13,0,100.0,0.0
커피식구 성수센터,13,13,0,100.0,0.0
오카보카,13,13,0,100.0,0.0
미도림,13,12,1,92.3,7.7
쭈전부리,13,13,0,100.0,0.0
이월로스터스 성수점,13,12,1,92.3,7.7
스프레이,13,13,0,100.0,0.0
커피온리 뚝섬역점,13,13,0,100.0,0.0
행복한식당,13,13,0,100.0,0.0
쑤쑤타이,13,12,1,92.3,7.7
걸작떡볶이치킨 성수점,13,13,0,100.0,0.0
다모아뷔페,13,13,0,100.0,0.0
피자헛 성수점,13,13,0,100.0,0.0
담소소사골순대육개장 성수시그마밸리점,13,11,2,84.6,15.4
눈꽃돼지,13,13,0,100.0,0.0
옛골감자탕,12,12,0,100.0,0.0
성수차이나,12,11,1,91.7,8.3
찐짜솥뚜껑삼겹살갈비,12,12,0,100.0,0.0
더리터 성수역점,12,11,1,91.7,8.3
서울에스프레소,12,11,1,91.7,8.3
코트사이드,12,12,0,100.0,0.0
루덴스파트너스,12,10,2,83.3,16.7
위풍당당족발,12,12,0,100.0,0.0
레드이즈미,12,12,0,100.0,0.0
햄찌와베찌,12,12,0,100.0,0.0
돈앤돈 성수점,12,8,4,66.7,33.3
왕돈까스&왕냉면 뚝섬점,12,10,2,83.3,16.7
예바다,12,12,0,100.0,0.0
홍낭자와김도령 성수낙낙점,12,12,0,100.0,0.0
오발탄 서울숲점,12,12,0,100.0,0.0
업사이드커피 연무장점,12,12,0,100.0,0.0
피자스쿨 성수쇼핑센타점,12,12,0,100.0,0.0
성수동 간판없는집,12,11,1,91.7,8.3
칠성옻닭,12,11,1,91.7,8.3
한끼밥집,12,11,1,91.7,8.3
왕짜장,12,12,0,100.0,0.0
또치 참숯생고기,12,12,0,100.0,0.0
안뜰 생선구이동태대구탕 뚝섬역점,12,12,0,100.0,0.0
구스케이지,12,12,0,100.0,0.0
곡성,12,12,0,100.0,0.0
뚝섬해물탕,12,10,2,83.3,16.7
엘몰리노,12,11,1,91.7,8.3
피자스쿨 뚝섬역점,12,11,1,91.7,8.3
늘봄숯불갈비,12,11,1,91.7,8.3
성수일구,12,11,1,91.7,8.3
햄찌와베찌 뚝섬점,12,12,0,100.0,0.0
화로양미,12,12,0,100.0,0.0
사흘카레,12,12,0,100.0,0.0
킴스치킨,12,11,1,91.7,8.3
소문난성수감자탕,12,10,2,83.3,16.7
성운,11,11,0,100.0,0.0
카페온화 본사,11,11,0,100.0,0.0
장수숯불갈비,11,10,1,90.9,9.1
이우 다이닝,11,11,0,100.0,0.0
더벤티 성수아이에스점,11,11,0,100.0,0.0
보난자 베이커리,11,11,0,100.0,0.0
하노이바게트,11,10,1,90.9,9.1
우디집,11,11,0,100.0,0.0
가장맛있는족발 뚝섬역점,11,9,2,81.8,18.2
마이쥬스 성수낙낙점,11,11,0,100.0,0.0
피리어드,11,11,0,100.0,0.0
토마토김밥 뚝섬역점,11,11,0,100.0,0.0
란칼국수,11,11,0,100.0,0.0
성수칼국수,11,11,0,100.0,0.0
레스카페,11,11,0,100.0,0.0
용짜장,11,11,0,100.0,0.0
한서칼국수,11,11,0,100.0,0.0
착한족발 성수점,11,10,1,90.9,9.1
은식당,11,10,1,90.9,9.1
밀향기,11,11,0,100.0,0.0
희정보감족,11,11,0,100.0,0.0
우콘카레,11,10,1,90.9,9.1
마이올드포스터,11,11,0,100.0,0.0
B1 KITCHEN,11,11,0,100.0,0.0
나이스두잉 버거샵,11,11,0,100.0,0.0
신사소곱창 성수점,11,9,2,81.8,18.2
땡기면땡비어,11,10,1,90.9,9.1
쿠시범,11,8,3,72.7,27.3
교촌치킨 성수역점,11,11,0,100.0,0.0
라성천사,11,10,1,90.9,9.1
죽변항,11,8,3,72.7,27.3
BBQ치킨 성수2점,11,11,0,100.0,0.0
고기다 성수점,10,10,0,100.0,0.0
와인쌤마켓 성수낙낙점,10,10,0,100.0,0.0
커어피 & 젤라또,10,10,0,100.0,0.0
camouflage coffee,10,10,0,100.0,0.0
성일정육식당,10,10,0,100.0,0.0
어묵나라 뚝섬점,10,10,0,100.0,0.0
그린한식뷔페,10,10,0,100.0,0.0
삼원,10,10,0,100.0,0.0
60계치킨 서울성수점,10,10,0,100.0,0.0
우리칼국수,10,10,0,100.0,0.0
까사다루아,10,9,1,90.0,10.0
성수기,10,10,0,100.0,0.0
레드브릭스모크하우스,10,10,0,100.0,0.0
성수동꿀꽈배기,10,10,0,100.0,0.0
맛닭꼬 성수뚝도점,10,10,0,100.0,0.0
순심이네생삼겹,10,10,0,100.0,0.0
성수동양갈비,10,10,0,100.0,0.0
Salad No.6,10,10,0,100.0,0.0
죽이야기 서울 뚝섬역점,10,9,1,90.0,10.0
송범순대국,10,9,1,90.0,10.0
높은산,10,10,0,100.0,0.0
기왕생고기,10,10,0,100.0,0.0
오와리 주막,10,8,2,80.0,20.0
온슬,10,9,1,90.0,10.0
파스쿠찌 서울숲점,10,10,0,100.0,0.0
삼미냉면칼국수,10,10,0,100.0,0.0
감요,10,10,0,100.0,0.0
송강제면소,10,10,0,100.0,0.0
투그,10,9,1,90.0,10.0
심마니약초백숙,10,10,0,100.0,0.0
JAFA Brewery,10,10,0,100.0,0.0
하남돼지집 성수역점,10,10,0,100.0,0.0
bakery tomo,10,10,0,100.0,0.0
색다른면,10,10,0,100.0,0.0
본가큰댁설렁탕 성수점,10,10,0,100.0,0.0
김가네김밥 성수시그마밸리점,10,9,1,90.0,10.0
목로정원,10,10,0,100.0,0.0
윤돈,10,10,0,100.0,0.0
성수숯불갈비,10,10,0,100.0,0.0
잭슨피자 성수점,10,9,1,90.0,10.0
오와리 뚝섬점,10,9,1,90.0,10.0
서래왕차돌 뚝섬역점,10,10,0,100.0,0.0
행운호프,10,10,0,100.0,0.0
나미 곰식당,9,9,0,100.0,0.0
성수골목,9,9,0,100.0,0.0
포미래,9,9,0,100.0,0.0
미각짬뽕양꼬치,9,8,1,88.9,11.1
호칼국수 성수점,9,9,0,100.0,0.0
노우노우바운즈,9,9,0,100.0,0.0
제로드,9,9,0,100.0,0.0
서울맛집,9,9,0,100.0,0.0
성수BONE 성수동한우짝갈비,9,9,0,100.0,0.0
전통숯불꼼장어,9,8,1,88.9,11.1
김밥천국 성수점,9,9,0,100.0,0.0
잇샐러드 성수점,9,7,2,77.8,22.2
삼천만활어횟집,9,9,0,100.0,0.0
다모토리혼,9,8,1,88.9,11.1
흙과나무,9,9,0,100.0,0.0
메쉬커피,9,9,0,100.0,0.0
부뚜막,9,9,0,100.0,0.0
전통씨래기국밥,9,9,0,100.0,0.0
밀단지,9,9,0,100.0,0.0
동촌샤브칼국수,9,9,0,100.0,0.0
시골집,9,8,1,88.9,11.1
뚝섬생고기,9,9,0,100.0,0.0
리브나 Rivna,9,9,0,100.0,0.0
해밀칼국수 성수점,9,8,1,88.9,11.1
두루치기김치찌개,9,9,0,100.0,0.0
도미노피자 서울숲점,9,8,1,88.9,11.1
왕분식,9,9,0,100.0,0.0
가마솥추어탕,9,9,0,100.0,0.0
진지방순대국,9,9,0,100.0,0.0
언니커피,9,9,0,100.0,0.0
아끄떼 뚜,9,9,0,100.0,0.0
본죽 뚝섬점,9,8,1,88.9,11.1
등심집,9,6,3,66.7,33.3
케슬리 본점,9,9,0,100.0,0.0
비스트리오,9,9,0,100.0,0.0
완백부대찌개삼겹살 성수낙낙점,9,8,1,88.9,11.1
유향소,9,9,0,100.0,0.0
호타루,9,9,0,100.0,0.0
신명먹거리,9,9,0,100.0,0.0
온더,9,9,0,100.0,0.0
포보스,9,8,1,88.9,11.1
성수 수집,9,9,0,100.0,0.0
메종 성수돈,9,9,0,100.0,0.0
플러드,9,9,0,100.0,0.0
BHC치킨 성수역점,9,9,0,100.0,0.0
우리동네칼국수,8,7,1,87.5,12.5
전주콩나물국밥,8,8,0,100.0,0.0
"밤의, 와인테라스&낮의, 피자테라스",8,7,1,87.5,12.5
올드너티 커피로스터스,8,8,0,100.0,0.0
양평서울해장국큰아들집 성동세무서점,8,8,0,100.0,0.0
신신원,8,8,0,100.0,0.0
프로가정식백반,8,8,0,100.0,0.0
비스트로 앤드투투,8,8,0,100.0,0.0
서울앵무새,8,7,1,87.5,12.5
다담,8,8,0,100.0,0.0
장맛손칼국수,8,8,0,100.0,0.0
뚝섬김밥,8,8,0,100.0,0.0
그레이트커피 서울숲점,8,8,0,100.0,0.0
맛차차,8,8,0,100.0,0.0
Cafe B&S,8,8,0,100.0,0.0
뜸들이다 성수점,8,8,0,100.0,0.0
둘둘치킨 성수1호점,8,8,0,100.0,0.0
모퉁이와플,8,8,0,100.0,0.0
컴포즈커피 성수점,8,8,0,100.0,0.0
성수 팍스부대찌개 본점,8,8,0,100.0,0.0
춘천닭갈비,8,8,0,100.0,0.0
암암리,8,8,0,100.0,0.0
고흥만,8,8,0,100.0,0.0
교촌치킨 성수1호점,8,8,0,100.0,0.0
파주부대찌개,8,8,0,100.0,0.0
홍정원,8,7,1,87.5,12.5
행운식당,8,7,1,87.5,12.5
플디 성수점,8,7,1,87.5,12.5
큰맘할매순대국 성수동점,8,8,0,100.0,0.0
오일장,8,8,0,100.0,0.0
청키드 성수점,8,8,0,100.0,0.0
참나무로 바베큐,8,8,0,100.0,0.0
생활맥주 성수역1번출구점,8,8,0,100.0,0.0
카페 마렐,8,8,0,100.0,0.0
최가네 국수 김밥,8,8,0,100.0,0.0
성수찰순대국,8,8,0,100.0,0.0
삼삼이네생고기 성수점,8,8,0,100.0,0.0
육육면관,8,7,1,87.5,12.5
과일파는 덕이언니,8,8,0,100.0,0.0
헤이피자,8,8,0,100.0,0.0
뜨리에이치,8,8,0,100.0,0.0
우야꼬칼국수파전,8,7,1,87.5,12.5
마포설농탕,8,8,0,100.0,0.0
서울왕돈까스 성수점,8,8,0,100.0,0.0
원할머니보쌈족발 성수점,8,7,1,87.5,12.5
영식품,8,8,0,100.0,0.0
베르두레 성수점,8,8,0,100.0,0.0
수제양정순대국 본점,8,8,0,100.0,0.0
교대이층집 성수점,8,6,2,75.0,25.0
DODODO,8,8,0,100.0,0.0
미엘릿,8,8,0,100.0,0.0
향토칼국수,8,8,0,100.0,0.0
이탈리안 누들,8,8,0,100.0,0.0
토끼와거북전,8,8,0,100.0,0.0
코스모스상점,8,8,0,100.0,0.0
자금성,8,8,0,100.0,0.0
원샷치킨,8,7,1,87.5,12.5
장가,8,7,1,87.5,12.5
오스테리아 로에로,7,7,0,100.0,0.0
풍년숯불돼지갈비,7,5,2,71.4,28.6
피카워크샵,7,7,0,100.0,0.0
BBQ치킨 성수3점,7,7,0,100.0,0.0
한경화설렁탕,7,7,0,100.0,0.0
호랑도,7,7,0,100.0,0.0
뚝도지기,7,7,0,100.0,0.0
서울숲오삼불고기,7,7,0,100.0,0.0
카페 투스프링,7,7,0,100.0,0.0
반가백암순대,7,7,0,100.0,0.0
CAFE FLARES,7,7,0,100.0,0.0
어부가,7,6,1,85.7,14.3
쁘띠 다이너,7,7,0,100.0,0.0
퍼멘티드 고스트,7,7,0,100.0,0.0
참참치킨 성수점,7,7,0,100.0,0.0
음악창고 LP BAR,7,7,0,100.0,0.0
진도부대찌개,7,7,0,100.0,0.0
업사이드커피 뚝섬점,7,7,0,100.0,0.0
코너룸,7,7,0,100.0,0.0
본도시락 성수점,7,7,0,100.0,0.0
리브릭,7,7,0,100.0,0.0
디스코커피,7,7,0,100.0,0.0
투다리 뚝섬점,7,6,1,85.7,14.3
김밥 어때,7,7,0,100.0,0.0
한세희복집,7,7,0,100.0,0.0
어페어커피,7,7,0,100.0,0.0
맛닭꼬 뚝섬점,7,7,0,100.0,0.0
무국적주점 거실,7,7,0,100.0,0.0
박가부대 성수코오롱디지털밸리점,7,6,1,85.7,14.3
밤새우리,7,7,0,100.0,0.0
국일돼지왕갈비생삼겹살,7,7,0,100.0,0.0
맛보래,7,7,0,100.0,0.0
혁신풍천민물장어 서울숲점,7,7,0,100.0,0.0
어커,7,7,0,100.0,0.0
아이아이알,7,7,0,100.0,0.0
카페 스트랏,7,7,0,100.0,0.0
그레이박스,7,7,0,100.0,0.0
청주한씨,7,6,1,85.7,14.3
성수동 리얼 로스팅 커피&디저트,7,7,0,100.0,0.0
이키나리돈부리,6,6,0,100.0,0.0
봉짬뽕,6,6,0,100.0,0.0
비놈,6,6,0,100.0,0.0
김종욱 커피,6,6,0,100.0,0.0
하우트제곱,6,6,0,100.0,0.0
카페 알렛츠,6,6,0,100.0,0.0
오비광장,6,5,1,83.3,16.7
유진참치,6,6,0,100.0,0.0
웰컴차이나,6,6,0,100.0,0.0
풍년정육점식당,6,6,0,100.0,0.0
코시나,6,5,1,83.3,16.7
셀렉토커피 서울숲IT캐슬점,6,6,0,100.0,0.0
구시월닭한마리,6,5,1,83.3,16.7
더존푸드,6,6,0,100.0,0.0
앙골로에스프레소,6,6,0,100.0,0.0
카페바로,6,6,0,100.0,0.0
찌마찌마,6,6,0,100.0,0.0
쥬씨 성수IT점,6,6,0,100.0,0.0
짬뽕타운,6,6,0,100.0,0.0
한남양옥 성수,6,6,0,100.0,0.0
우오보파스타바,6,6,0,100.0,0.0
EZER Coffee,6,6,0,100.0,0.0
신의주순대와쭈꾸미 성수점,6,6,0,100.0,0.0
잔치국수아줌마,6,6,0,100.0,0.0
스시라온,6,6,0,100.0,0.0
모어딥 성수,6,6,0,100.0,0.0
서울숲쭈꾸미,6,6,0,100.0,0.0
와인바킥,6,6,0,100.0,0.0
쵸리상경,6,5,1,83.3,16.7
송계옥성수점,6,6,0,100.0,0.0
커피베이 성동성수점,6,6,0,100.0,0.0
티핀,6,6,0,100.0,0.0
소나무커피,6,6,0,100.0,0.0
309디저트카페,6,6,0,100.0,0.0
홍천숯닭,6,6,0,100.0,0.0
성수스타우트,6,5,1,83.3,16.7
성수망치버거,6,6,0,100.0,0.0
일월수제만두,6,6,0,100.0,0.0
창창커피,6,6,0,100.0,0.0
죽고을,6,6,0,100.0,0.0
외가집,6,6,0,100.0,0.0
크레송,6,6,0,100.0,0.0
플라이팬커피 뚝섬점,6,6,0,100.0,0.0
백억포차,6,6,0,100.0,0.0
어글리크림치즈,6,6,0,100.0,0.0
카페크라비,6,6,0,100.0,0.0
모므로살롱,6,6,0,100.0,0.0
백리향중화요리,6,6,0,100.0,0.0
테이블 소사이어티 클럽,6,6,0,100.0,0.0
후다닭Q 본점,6,5,1,83.3,16.7
닭한마리,6,6,0,100.0,0.0
낙타커피로스터스,6,6,0,100.0,0.0
물레방아민물매운탕,6,6,0,100.0,0.0
라스베이글 성수점,6,5,1,83.3,16.7
옛날순대국밥,6,6,0,100.0,0.0
탕 김치찌개,6,6,0,100.0,0.0
피터팬돈까스,6,6,0,100.0,0.0
버터컵,6,6,0,100.0,0.0
신성웰빙족발,6,6,0,100.0,0.0
투달러스커피,6,6,0,100.0,0.0
둘둘치킨 뚝섬점,6,6,0,100.0,0.0
더킹돈 뚝섬점,5,5,0,100.0,0.0
하루나,5,5,0,100.0,0.0
푸라닭 성수2가점,5,5,0,100.0,0.0
성수찌개,5,5,0,100.0,0.0
생삼겹장수유황오리,5,5,0,100.0,0.0
내추럴,5,5,0,100.0,0.0
깡통집,5,5,0,100.0,0.0
뺌치킨,5,5,0,100.0,0.0
세스크멘슬,5,5,0,100.0,0.0
프라이데이무브먼트,5,5,0,100.0,0.0
성일식당아들네,5,5,0,100.0,0.0
성수장,5,4,1,80.0,20.0
복식커피,5,5,0,100.0,0.0
밥플러스 에이스하이엔드점,5,5,0,100.0,0.0
전주식당,5,5,0,100.0,0.0
제스티살룬성수,5,5,0,100.0,0.0
천수곱창,5,4,1,80.0,20.0
역삼칼국수,5,5,0,100.0,0.0
독도참치 성수점,5,5,0,100.0,0.0
샌드카베,5,5,0,100.0,0.0
소안도풍경,5,5,0,100.0,0.0
LOWIDE,5,5,0,100.0,0.0
블루보틀성수점,5,5,0,100.0,0.0
알파카페,5,5,0,100.0,0.0
넘버파이브,5,5,0,100.0,0.0
숲속식사 철판볶음밥,5,5,0,100.0,0.0
도토루커피os,5,4,1,80.0,20.0
2002횟집,5,5,0,100.0,0.0
민티베리,5,4,1,80.0,20.0
개성상인,5,5,0,100.0,0.0
밥플러스 성수에이팩센터점,5,5,0,100.0,0.0
복닭 성수점,5,5,0,100.0,0.0
담바골,5,5,0,100.0,0.0
부성식당,5,5,0,100.0,0.0
Naked Coffee,5,3,2,60.0,40.0
시골가마솥삼겹살 성수점,5,5,0,100.0,0.0
밥플러스 6호점,5,5,0,100.0,0.0
얼큰이왕냉면,5,5,0,100.0,0.0
에이치커피로스터스,5,5,0,100.0,0.0
동맛골보쌈칼국수,5,5,0,100.0,0.0
얼룩,5,5,0,100.0,0.0
일미돼지국밥,5,5,0,100.0,0.0
amado,5,5,0,100.0,0.0
커피식탁,5,5,0,100.0,0.0
리퀴드랩,5,5,0,100.0,0.0
태풍순대국,5,5,0,100.0,0.0
모멘토브루어스,5,5,0,100.0,0.0
네네치킨 성수2가점,5,5,0,100.0,0.0
Make,5,5,0,100.0,0.0
양과자점 라보엠,5,5,0,100.0,0.0
윤스김밥,5,4,1,80.0,20.0
현대옥 서울숲점,5,5,0,100.0,0.0
뚝섬삼겹,5,4,1,80.0,20.0
가내수공업고깃집,5,5,0,100.0,0.0
뱅글,5,5,0,100.0,0.0
INDICA,5,4,1,80.0,20.0
알천 성동본점,5,5,0,100.0,0.0
영구스피자 성수점,5,5,0,100.0,0.0
에그마카슈 성수,5,5,0,100.0,0.0
행운한식뷔페,5,5,0,100.0,0.0
100회,5,5,0,100.0,0.0
매머드익스프레스 서울숲코오롱1차점,5,5,0,100.0,0.0
매너커피,4,4,0,100.0,0.0
베러로스팅랩&쇼룸,4,4,0,100.0,0.0
레타주,4,4,0,100.0,0.0
SooLit,4,4,0,100.0,0.0
다미,4,4,0,100.0,0.0
솔솥성수점,4,4,0,100.0,0.0
킨더프레스 에스프레소 바 성수뚝섬점,4,3,1,75.0,25.0
포지티브 제로 라운지,4,3,1,75.0,25.0
로우커피스탠드 성수점,4,4,0,100.0,0.0
pvglab,4,4,0,100.0,0.0
대돈집,4,4,0,100.0,0.0
55주막,4,4,0,100.0,0.0
나나횟집,4,4,0,100.0,0.0
밥플러스 아이티캐슬점,4,4,0,100.0,0.0
행복식당,4,3,1,75.0,25.0
카페리빈 성수점,4,4,0,100.0,0.0
장미통닭집,4,4,0,100.0,0.0
압구정샌드위치 성수점,4,4,0,100.0,0.0
독보,4,4,0,100.0,0.0
미사랑,4,4,0,100.0,0.0
서후와규,4,4,0,100.0,0.0
을지로골뱅이,4,4,0,100.0,0.0
춘천닭갈비낙지철판,4,4,0,100.0,0.0
커피베이 서울숲AK밸리점,4,4,0,100.0,0.0
종가빈대떡,4,4,0,100.0,0.0
키보우 라멘,4,2,2,50.0,50.0
성수낙지,4,4,0,100.0,0.0
박가객주,4,4,0,100.0,0.0
송가,4,4,0,100.0,0.0
일루오리,4,4,0,100.0,0.0
행닭바베큐통닭,4,4,0,100.0,0.0
풍년식당,4,4,0,100.0,0.0
그린웰빙한식부페,4,4,0,100.0,0.0
우리집밥,4,4,0,100.0,0.0
호식이두마리치킨 서울숲점,4,4,0,100.0,0.0
새촌131,4,4,0,100.0,0.0
앙심품은도야지,4,3,1,75.0,25.0
모루타루,4,4,0,100.0,0.0
콜렉트,4,4,0,100.0,0.0
브로벨커피,4,4,0,100.0,0.0
쿠켄치킨호프 성수점,4,4,0,100.0,0.0
파라디,4,4,0,100.0,0.0
성수손칼국수,4,4,0,100.0,0.0
레이어57 카페,4,4,0,100.0,0.0
빨간마초닭발 성수점,4,4,0,100.0,0.0
황소미가,4,4,0,100.0,0.0
태양각,4,4,0,100.0,0.0
윤식당 한식뷔페,4,4,0,100.0,0.0
성수동골룸 서울숲 해산물 포장마차,4,4,0,100.0,0.0
대박낙소 성수점,4,4,0,100.0,0.0
미정이네식당,4,4,0,100.0,0.0
더퍼즈,3,3,0,100.0,0.0
장흥식당,3,3,0,100.0,0.0
온에떼라,3,3,0,100.0,0.0
카페랏102,3,3,0,100.0,0.0
하피,3,3,0,100.0,0.0
스몰글라스,3,3,0,100.0,0.0
호랑이식탁,3,3,0,100.0,0.0
LAZZO,3,3,0,100.0,0.0
경수식당,3,3,0,100.0,0.0
야끼도리정,3,3,0,100.0,0.0
그룬트,3,3,0,100.0,0.0
페이지스,3,3,0,100.0,0.0
탕가네,3,3,0,100.0,0.0
원조장충왕족발,3,3,0,100.0,0.0
88켄터키 성수점,3,3,0,100.0,0.0
싱싱횟집,3,3,0,100.0,0.0
진미식당,3,3,0,100.0,0.0
뚝도리보신탕,3,3,0,100.0,0.0
논스톱샌드위치,3,3,0,100.0,0.0
연탄요릿집,3,3,0,100.0,0.0
피자파는집 서울성수점,3,3,0,100.0,0.0
동신식당,3,3,0,100.0,0.0
셀럽드샐러드,3,3,0,100.0,0.0
맥스카나,3,3,0,100.0,0.0
리커버리커피바,3,3,0,100.0,0.0
너랑나랑 콩나물국밥삼겹살,3,3,0,100.0,0.0
울보분식,3,3,0,100.0,0.0
일정,3,3,0,100.0,0.0
부덕관,3,3,0,100.0,0.0
어썸브로시스,3,3,0,100.0,0.0
원앤하프,3,2,1,66.7,33.3
카페오라,3,3,0,100.0,0.0
형제갈비,3,3,0,100.0,0.0
이흥부오향족발 뚝섬점,3,3,0,100.0,0.0
땡초꼼장어,3,3,0,100.0,0.0
용싸롱,3,3,0,100.0,0.0
더반푸드,3,3,0,100.0,0.0
대흥정육식당,3,3,0,100.0,0.0
동호마을명태코다리,3,3,0,100.0,0.0
동강,3,2,1,66.7,33.3
차만다서울숲점,3,3,0,100.0,0.0
페를 perle,3,3,0,100.0,0.0
하이엔드라이,3,2,1,66.7,33.3
브레드온,3,3,0,100.0,0.0
큐리크,3,3,0,100.0,0.0
윕성수,3,3,0,100.0,0.0
우동가조쿠 성수점,3,2,1,66.7,33.3
모이크,3,3,0,100.0,0.0
피어커피로스터스,3,3,0,100.0,0.0
모호인,3,3,0,100.0,0.0
정든집,3,3,0,100.0,0.0
한돈급냉삼겹살,3,3,0,100.0,0.0
진작다이닝,3,3,0,100.0,0.0
카페온유,3,3,0,100.0,0.0
지코바치킨 성수1호점,3,3,0,100.0,0.0
백야드빌더성수,3,2,1,66.7,33.3
호호식당,3,3,0,100.0,0.0
마를리,3,3,0,100.0,0.0
카페라니,3,3,0,100.0,0.0
참숯나라갈비마을,3,3,0,100.0,0.0
민물집,3,3,0,100.0,0.0
후프커피,3,3,0,100.0,0.0
성수식당,3,3,0,100.0,0.0
청죽골 2호점,3,3,0,100.0,0.0
소바짐,3,3,0,100.0,0.0
중국관,3,3,0,100.0,0.0
병천순대국 성수점,3,2,1,66.7,33.3
per week,3,3,0,100.0,0.0
전주집,3,3,0,100.0,0.0
바탕,3,3,0,100.0,0.0
카나비스트릿,3,3,0,100.0,0.0
예셰숄,3,3,0,100.0,0.0
맛집이모네,2,2,0,100.0,0.0
한성식당,2,2,0,100.0,0.0
꾸이한끼 성수점,2,2,0,100.0,0.0
푸른바다횟집,2,2,0,100.0,0.0
조리,2,2,0,100.0,0.0
시장설렁탕,2,2,0,100.0,0.0
락지,2,2,0,100.0,0.0
야페,2,2,0,100.0,0.0
한끼,2,2,0,100.0,0.0
피에스비 커피바,2,2,0,100.0,0.0
광순네식당,2,2,0,100.0,0.0
봄의정원성수점,2,2,0,100.0,0.0
진국해장국,2,2,0,100.0,0.0
바위파스타바 성수,2,2,0,100.0,0.0
오프비트,2,2,0,100.0,0.0
몽련,2,2,0,100.0,0.0
할아버지공장,2,2,0,100.0,0.0
성수부엌,2,2,0,100.0,0.0
파치비 성수점,2,1,1,50.0,50.0
최가식당,2,2,0,100.0,0.0
바나나트리 성수점,2,2,0,100.0,0.0
해리커피,2,2,0,100.0,0.0
오드비,2,2,0,100.0,0.0
코사이어티 서울숲,2,2,0,100.0,0.0
청진동해장국 성수점,2,2,0,100.0,0.0
시골밥상,2,2,0,100.0,0.0
룰루랄라 뚝섬역점,2,2,0,100.0,0.0
호남식당,2,2,0,100.0,0.0
더반 베를린 성수점,2,2,0,100.0,0.0
남매칼국수,2,2,0,100.0,0.0
도믹스,2,2,0,100.0,0.0
93밀리언마일즈,2,2,0,100.0,0.0
센터커피,2,2,0,100.0,0.0
살롱드가벵양,2,2,0,100.0,0.0
슬로우캘리 뚝섬역점,2,2,0,100.0,0.0
성수베이킹스튜디오,2,2,0,100.0,0.0
더블핸스테이크 서울숲점,2,2,0,100.0,0.0
뺑드에코,2,2,0,100.0,0.0
명동할머니국수 성수카페거리점,2,2,0,100.0,0.0
오스테리아쟌니,2,2,0,100.0,0.0
성수뚝배기,2,2,0,100.0,0.0
밀도,2,2,0,100.0,0.0
5스타커피 셀렉트샵 서울숲점,2,2,0,100.0,0.0
꾸아,2,2,0,100.0,0.0
어니언성수점,2,1,1,50.0,50.0
어촌횟집,2,1,1,50.0,50.0
자매집생선구이,2,2,0,100.0,0.0
밤토리,2,2,0,100.0,0.0
파파존스 성수점,2,2,0,100.0,0.0
비밀의정원,2,2,0,100.0,0.0
빌런,2,2,0,100.0,0.0
성연순대국&족발,2,2,0,100.0,0.0
성수동꽈배기 로고스타,2,2,0,100.0,0.0
연탄구이집,2,2,0,100.0,0.0
청수먹거리,2,2,0,100.0,0.0
신촌설렁탕,2,2,0,100.0,0.0
혜성분식,2,2,0,100.0,0.0
커피사피엔스 선명스퀘어점,2,1,1,50.0,50.0
IT 뷔페,2,2,0,100.0,0.0
남원콩나물국밥,2,2,0,100.0,0.0
금돼지,2,1,1,50.0,50.0
백두대간 성수점,2,2,0,100.0,0.0
두남자의개수작,2,2,0,100.0,0.0
오니기리와이규동 성수점,2,2,0,100.0,0.0
쓰리오브어스,2,2,0,100.0,0.0
우영푸드빌,2,2,0,100.0,0.0
굴국밥현이네,2,2,0,100.0,0.0
커피코코,2,2,0,100.0,0.0
야곱293,2,2,0,100.0,0.0
더다미,2,2,0,100.0,0.0
최가네부대찌개,2,2,0,100.0,0.0
언커먼그라운드,2,2,0,100.0,0.0
온누리식당,2,2,0,100.0,0.0
원조감자탕,2,2,0,100.0,0.0
성수명당,2,2,0,100.0,0.0
별미식당,2,2,0,100.0,0.0
심토불이,2,2,0,100.0,0.0
씨에이크,2,2,0,100.0,0.0
머니뭐니 성수점,2,2,0,100.0,0.0
조양생고기순대국,2,1,1,50.0,50.0
명인갈비 성수점,1,1,0,100.0,0.0
맛부,1,1,0,100.0,0.0
서산식당,1,1,0,100.0,0.0
소소하게,1,1,0,100.0,0.0
포크앤라이프,1,1,0,100.0,0.0
큐씨오,1,1,0,100.0,0.0
스트로베리32,1,1,0,100.0,0.0
소랑호젠,1,1,0,100.0,0.0
대포차,1,1,0,100.0,0.0
더키더키,1,1,0,100.0,0.0
남경관,1,1,0,100.0,0.0
니드인,1,1,0,100.0,0.0
돼지네생삼겹살,1,1,0,100.0,0.0
배떡 성수점,1,1,0,100.0,0.0
부경,1,1,0,100.0,0.0
이트앤드링크,1,1,0,100.0,0.0
정참치,1,1,0,100.0,0.0
얌커피,1,1,0,100.0,0.0
마포숫불갈비,1,1,0,100.0,0.0
세밀,1,1,0,100.0,0.0
와규오감,1,1,0,100.0,0.0
카페 뮤,1,1,0,100.0,0.0
YENA,1,1,0,100.0,0.0
복돼지,1,0,1,0.0,100.0
곱씹어you,1,1,0,100.0,0.0
슈퍼오리,1,1,0,100.0,0.0
여기가좋겠네,1,1,0,100.0,0.0
오늘도못참치,1,1,0,100.0,0.0
성수다락,1,1,0,100.0,0.0
씨씨씨,1,1,0,100.0,0.0
진수성찬한식뷔페,1,1,0,100.0,0.0
벼리다,1,1,0,100.0,0.0
소녀방앗간,1,1,0,100.0,0.0
대림창고,1,1,0,100.0,0.0
소문난생만두 성수역점,1,1,0,100.0,0.0
성수족발,1,1,0,100.0,0.0
마스,1,1,0,100.0,0.0
메이플탑,1,1,0,100.0,0.0
화양리우동집,1,1,0,100.0,0.0
멜로워,1,1,0,100.0,0.0
미리내,1,1,0,100.0,0.0
에르제,1,0,1,0.0,100.0
오므오트,1,1,0,100.0,0.0
장안식당,1,1,0,100.0,0.0
아카보시,1,1,0,100.0,0.0
카페아모렘,1,1,0,100.0,0.0
뚝도국수집,1,1,0,100.0,0.0
5to7,1,1,0,100.0,0.0
수칼국수,1,1,0,100.0,0.0
카페그라운드시소,1,1,0,100.0,0.0
메모레,1,1,0,100.0,0.0
퀴바라,1,1,0,100.0,0.0
에바스,1,1,0,100.0,0.0
피자스쿨 성수점,1,1,0,100.0,0.0
훈이네,1,1,0,100.0,0.0
뚝도수산,1,1,0,100.0,0.0
라성키친,1,1,0,100.0,0.0
레이어10 카페,1,1,0,100.0,0.0
릴레이션 카페,1,1,0,100.0,0.0
장위동유성집 성동점,1,1,0,100.0,0.0
오가네숯불곰장어,1,1,0,100.0,0.0
내고향정육점식당,1,1,0,100.0,0.0
황기닭한마리,1,1,0,100.0,0.0
진한식부페,1,1,0,100.0,0.0
제일,1,1,0,100.0,0.0
감닭오구공공,1,1,0,100.0,0.0
카페일로,1,1,0,100.0,0.0
써니,1,1,0,100.0,0.0
순심이네,1,1,0,100.0,0.0
dooop,1,1,0,100.0,0.0
국보전,1,1,0,100.0,0.0
맥문동호프,1,1,0,100.0,0.0
뚝시돈,1,1,0,100.0,0.0
성공is100,1,1,0,100.0,0.0
까칠이,1,1,0,100.0,0.0
철규네분식,1,1,0,100.0,0.0
무등산닭한마리,1,1,0,100.0,0.0
딤플맥주양주,1,1,0,100.0,0.0
Dii,1,1,0,100.0,0.0
현영이네,1,1,0,100.0,0.0
엄마네냄비밥,1,1,0,100.0,0.0
경성찹쌀꽈배기 뚝섬점,1,1,0,100.0,0.0
행복한 곱창,1,1,0,100.0,0.0
미정이네코다리찜,1,1,0,100.0,0.0
또래오래 성수점,1,1,0,100.0,0.0
카페 메이,1,1,0,100.0,0.0
생태한마리,1,1,0,100.0,0.0
카라,1,1,0,100.0,0.0
제이엠,1,1,0,100.0,0.0
강남빈대떡,1,1,0,100.0,0.0
비어호프,1,0,1,0.0,100.0
쁘띠그랑,1,1,0,100.0,0.0
숙영이네,1,1,0,100.0,0.0
하루참치랑연어랑,1,1,0,100.0,0.0
치카성수,1,1,0,100.0,0.0
뿐또블루,1,0,1,0.0,100.0
뽀식이네부페식당,1,1,0,100.0,0.0
제주올레포차 2호점,1,1,0,100.0,0.0
베트남쌀국수,1,1,0,100.0,0.0
인덱스카라멜,1,1,0,100.0,0.0
잇쇼우,1,1,0,100.0,0.0
맞닿음 성수점,1,1,0,100.0,0.0
골목집,1,1,0,100.0,0.0
