호텔,리뷰 개수,긍정 리뷰 개수,부정 리뷰 개수,긍정 리뷰 비율,부정 리뷰 비율
bd버거 성수,262,252,10,96.2,3.8
캐스터네츠 서울숲점,179,172,7,96.1,3.9
문츠 바베큐,163,157,6,96.3,3.7
밥밥디라라 뚝섬역점,148,147,1,99.3,0.7
고집132 성수본점,142,139,3,97.9,2.1
"여기 런던 Here, london",132,132,0,100.0,0.0
오프트,130,127,3,97.7,2.3
성수온실,121,120,1,99.2,0.8
보마켓 서울숲점,115,110,5,95.7,4.3
오우드 성수1호점,113,105,8,92.9,7.1
파머스카페,112,107,5,95.5,4.5
크림라벨 서울숲 본점,105,103,2,98.1,1.9
성수옥아궁지 성수본점,103,102,1,99.0,1.0
망티커피 성수점,101,95,6,94.1,5.9
인치스,96,95,1,99.0,1.0
메종 파이프그라운드,93,88,5,94.6,5.4
메가MGC커피 서울숲역점,91,77,14,84.6,15.4
로우커피스탠드,91,89,2,97.8,2.2
권식족발 성수본점,89,89,0,100.0,0.0
노가리마켓 서울숲,85,79,6,92.9,7.1
후라토식당 성수점,85,83,2,97.6,2.4
테디스오븐,84,79,5,94.0,6.0
성수삐딱,82,66,16,80.5,19.5
세디치,82,81,1,98.8,1.2
로우키,81,78,3,96.3,3.7
페이퍼 플레이트,81,81,0,100.0,0.0
팔각도 성수역점,81,80,1,98.8,1.2
앤드밀 성수점,81,79,2,97.5,2.5
연남토마 성수점,79,75,4,94.9,5.1
다포케 성수점,79,73,6,92.4,7.6
다운타우너 성수 피치스,78,77,1,98.7,1.3
대성갈비,78,70,8,89.7,10.3
구아바,77,75,2,97.4,2.6
뚝도농원,77,65,12,84.4,15.6
맘스터치 성수역점,76,66,10,86.8,13.2
천상가옥,76,73,3,96.1,3.9
노모어피자 서울숲점,75,74,1,98.7,1.3
미도인 성수,75,69,6,92.0,8.0
엘더버거,75,70,5,93.3,6.7
밸런스포케 서울숲점,75,74,1,98.7,1.3
아울림,73,71,2,97.3,2.7
성수김밥 퍼니텅,73,73,0,100.0,0.0
쿠나,73,72,1,98.6,1.4
이오로비스트로,73,70,3,95.9,4.1
미아논나,73,71,2,97.3,2.7
비스트로성수,72,70,2,97.2,2.8
계모임,72,72,0,100.0,0.0
쿠키샾,71,69,2,97.2,2.8
누메로도스,70,69,1,98.6,1.4
도렐 성수점,69,64,5,92.8,7.2
까망,69,69,0,100.0,0.0
훼미리손칼국수보쌈,69,65,4,94.2,5.8
카린지_린가네 스낵바,68,66,2,97.1,2.9
쎈느Scene,68,66,2,97.1,2.9
슈퍼말차 성수,68,66,2,97.1,2.9
멘야코노하 성수,67,67,0,100.0,0.0
하프커피 성수,67,66,1,98.5,1.5
프롤라,67,63,4,94.0,6.0
윤경양식당,67,64,3,95.5,4.5
강남면옥 성수점,66,60,6,90.9,9.1
만학,66,59,7,89.4,10.6
가조쿠,65,63,2,96.9,3.1
까치화방 성수낙낙점,65,63,2,96.9,3.1
오레노카츠 성수본점,65,65,0,100.0,0.0
티룸,65,64,1,98.5,1.5
라프레플루트,64,61,3,95.3,4.7
위스위츠,63,62,1,98.4,1.6
샐러디 성수점,63,62,1,98.4,1.6
성수노루,62,59,3,95.2,4.8
어메이징브루잉컴퍼니,62,59,3,95.2,4.8
카멜커피 성수점,61,55,6,90.2,9.8
서울숲누룽지통닭구이,60,54,6,90.0,10.0
벨라스가든 서울숲점,60,58,2,96.7,3.3
스시메이 성수점,60,60,0,100.0,0.0
하노이102,59,56,3,94.9,5.1
훔볼트,59,57,2,96.6,3.4
stdo,59,55,4,93.2,6.8
파르코,58,57,1,98.3,1.7
팜티진쌀국수,58,55,3,94.8,5.2
피키니키 라자냐,58,57,1,98.3,1.7
써브웨이 성수역점,58,55,3,94.8,5.2
바이레인,57,56,1,98.2,1.8
유가츠,56,51,5,91.1,8.9
오스테리아 파로,55,54,1,98.2,1.8
공차 서울숲점,55,55,0,100.0,0.0
무식당 성수본점,55,41,14,74.5,25.5
소년식당,55,51,4,92.7,7.3
브라운래빗 서울숲점,55,53,2,96.4,3.6
버섯집,54,54,0,100.0,0.0
꿉당 성수점,54,51,3,94.4,5.6
할머니의 레시피,54,51,3,94.4,5.6
롸카두들 내쉬빌 핫치킨 성수점,54,54,0,100.0,0.0
포배럴카페,53,48,5,90.6,9.4
목금,53,52,1,98.1,1.9
윌리스엘에이피자,53,53,0,100.0,0.0
굿갓레스토랑 성수역점,53,51,2,96.2,3.8
위드번,53,52,1,98.1,1.9
호감도,52,51,1,98.1,1.9
보스코 에스프레소 바,52,48,4,92.3,7.7
바르다김선생 서울숲점,52,42,10,80.8,19.2
체다앤올리,52,45,7,86.5,13.5
뚜르띠에르,52,48,4,92.3,7.7
화이트글래스,50,49,1,98.0,2.0
시옹마오,50,49,1,98.0,2.0
컴포즈커피 화양사거리점,49,47,2,95.9,4.1
올댓커피 포레스트점,49,48,1,98.0,2.0
슈에뜨펍,49,48,1,98.0,2.0
성수옥상,49,46,3,93.9,6.1
퀴버 서울숲,49,48,1,98.0,2.0
기후,48,46,2,95.8,4.2
베티버 성수,48,48,0,100.0,0.0
히즈빈스 성수점,48,48,0,100.0,0.0
정선부뚜막,48,47,1,97.9,2.1
올드너티 커피로스터스,48,47,1,97.9,2.1
정돈 성수점,48,46,2,95.8,4.2
일일향 성수10호점,48,42,6,87.5,12.5
까까를로,48,48,0,100.0,0.0
무브모브 성수,47,47,0,100.0,0.0
감도 성수점,46,43,3,93.5,6.5
마크69,46,43,3,93.5,6.5
공차 성수역점,46,44,2,95.7,4.3
빠오즈푸 서울숲직영점,46,44,2,95.7,4.3
화화담 성수,46,44,2,95.7,4.3
신선식탁 성수역점,46,46,0,100.0,0.0
지우관,46,45,1,97.8,2.2
벱,46,44,2,95.7,4.3
201호,45,45,0,100.0,0.0
잠수교집 성수 직영점,45,43,2,95.6,4.4
야드 서울,45,42,3,93.3,6.7
BNHR,45,41,4,91.1,8.9
희릿,45,44,1,97.8,2.2
스케줄 성수,45,42,3,93.3,6.7
니드스윗,44,44,0,100.0,0.0
수원원조갈비,44,33,11,75.0,25.0
버니타운,44,44,0,100.0,0.0
뜨리에이치,44,43,1,97.7,2.3
푸르너스가든 서울숲,44,43,1,97.7,2.3
빙봉,44,38,6,86.4,13.6
호랑이 초밥,44,44,0,100.0,0.0
투썸플레이스 성수skv타워점,43,39,4,90.7,9.3
유어네이키드치즈,43,42,1,97.7,2.3
비트랩,43,43,0,100.0,0.0
퍼먼트,43,40,3,93.0,7.0
포맨스,43,37,6,86.0,14.0
카페&펍 연무장,43,38,5,88.4,11.6
어퍼룸,43,43,0,100.0,0.0
글로우,42,41,1,97.6,2.4
미디엄스톤 성수점,42,42,0,100.0,0.0
하늘분식,42,37,5,88.1,11.9
버거보이 성수낙낙점,42,39,3,92.9,7.1
위키드와이프,41,39,2,95.1,4.9
폴인레미유 성수점,41,40,1,97.6,2.4
마하차이 성수본점,41,40,1,97.6,2.4
빙맥홀닭 서울숲점,40,40,0,100.0,0.0
구욱희씨 서울숲점,40,37,3,92.5,7.5
사람사는 고깃집 김일도 성수점,40,40,0,100.0,0.0
오스테리아 로에로,39,39,0,100.0,0.0
김밥천국 서울숲점,39,38,1,97.4,2.6
제제,39,37,2,94.9,5.1
땅스부대찌개 성수점,39,39,0,100.0,0.0
메가MGC커피 성수일로점,39,38,1,97.4,2.6
발렁스,39,39,0,100.0,0.0
소바마에,38,37,1,97.4,2.6
나누리잡화점,38,34,4,89.5,10.5
묘사서울,38,38,0,100.0,0.0
티케,38,37,1,97.4,2.6
Pauline CoffeeBar,38,38,0,100.0,0.0
왕삼겹정육식당,38,38,0,100.0,0.0
화랑직화구이,38,38,0,100.0,0.0
성수로운,38,37,1,97.4,2.6
중화카츠 서울숲,38,38,0,100.0,0.0
성수우동,37,36,1,97.3,2.7
써브웨이 서울숲점,37,31,6,83.8,16.2
르셀,37,37,0,100.0,0.0
더카페 서울숲역점,37,37,0,100.0,0.0
소바식당,36,34,2,94.4,5.6
대낚식당,36,36,0,100.0,0.0
성수이루다,36,35,1,97.2,2.8
도치피자 성수,36,35,1,97.2,2.8
고공 성수본점,36,36,0,100.0,0.0
평이담백뼈칼국수 성수점,36,36,0,100.0,0.0
빽다방 뚝섬역점,36,34,2,94.4,5.6
칙피스 성수점,36,36,0,100.0,0.0
차이나플레인 서울숲점,36,35,1,97.2,2.8
루디먼트,36,35,1,97.2,2.8
춘하추우동,35,35,0,100.0,0.0
타이거풀,35,32,3,91.4,8.6
레이더,35,31,4,88.6,11.4
헤비스테이크 성수점,35,32,3,91.4,8.6
오늘애김밥 성수역점,35,33,2,94.3,5.7
홍화돈,35,32,3,91.4,8.6
록멘,34,32,2,94.1,5.9
송흥,34,33,1,97.1,2.9
미오 도쿄 다이닝,34,32,2,94.1,5.9
써니눅,34,34,0,100.0,0.0
동빙고 성수점,34,31,3,91.2,8.8
잇샐러드 성수점,34,32,2,94.1,5.9
롯데리아 성수역점,34,32,2,94.1,5.9
마리오네,34,33,1,97.1,2.9
금금 성수점,34,33,1,97.1,2.9
힘이나는커피생활 성수2호점,33,32,1,97.0,3.0
승리원,33,32,1,97.0,3.0
마블상회,33,33,0,100.0,0.0
소인수서울 본점,33,30,3,90.9,9.1
도도한면 성수본점,33,33,0,100.0,0.0
업사이드커피,33,32,1,97.0,3.0
등촌샤브칼국수 성수점,33,28,5,84.8,15.2
본노엘 성수점,32,30,2,93.8,6.2
뚝 다이닝,32,29,3,90.6,9.4
dyscoffee,32,32,0,100.0,0.0
에이투비 Cafe&Bar,32,32,0,100.0,0.0
포동푸딩,32,31,1,96.9,3.1
피자시즌,32,32,0,100.0,0.0
포지티브 서울숲,31,31,0,100.0,0.0
리틀포레스트,31,28,3,90.3,9.7
청담순대국,31,31,0,100.0,0.0
빽다방 화양사거리점,31,30,1,96.8,3.2
삼원,31,30,1,96.8,3.2
마구로쇼쿠도,31,30,1,96.8,3.2
봉쥬르,31,30,1,96.8,3.2
고운 돈카츠,31,31,0,100.0,0.0
홍콩반점0410 성수역점,31,27,4,87.1,12.9
기미사 성수,30,28,2,93.3,6.7
HDD피자,30,30,0,100.0,0.0
매머드익스프레스 성수역점,30,28,2,93.3,6.7
누아흐,30,30,0,100.0,0.0
유스트레스,30,29,1,96.7,3.3
아키야마,29,28,1,96.6,3.4
오토김밥 서울숲점,29,27,2,93.1,6.9
스시오오모토,29,23,6,79.3,20.7
누메로뜨레쓰,29,29,0,100.0,0.0
멜라 성수점,29,27,2,93.1,6.9
마하차이 서울숲점,29,28,1,96.6,3.4
육육면관,29,29,0,100.0,0.0
어라운드데이,29,29,0,100.0,0.0
기러기둥지 성수,29,28,1,96.6,3.4
동대문엽기떡볶이 성수점,28,27,1,96.4,3.6
뚝섬숯불갈비,28,24,4,85.7,14.3
탕화쿵푸마라탕 성수동지점,28,27,1,96.4,3.6
오우도,28,27,1,96.4,3.6
단일서울,28,27,1,96.4,3.6
디플랫 성수,28,26,2,92.9,7.1
성수동 리얼 로스팅 커피&디저트,28,27,1,96.4,3.6
오근내7닭갈비,27,27,0,100.0,0.0
이곳에,27,26,1,96.3,3.7
샹도르본사직영점,27,23,4,85.2,14.8
이로우,27,25,2,92.6,7.4
보이어,27,27,0,100.0,0.0
오카보카,27,27,0,100.0,0.0
모모야 성수점,27,27,0,100.0,0.0
굴림,27,26,1,96.3,3.7
신사동 벼락집,26,25,1,96.2,3.8
신라다랑원 성수점,26,25,1,96.2,3.8
그리너 성수1가점,26,22,4,84.6,15.4
아비꼬 성수역점,26,22,4,84.6,15.4
짬뽕위에더짬뽕,26,24,2,92.3,7.7
그라데이션커피,26,26,0,100.0,0.0
성수맥주,26,25,1,96.2,3.8
온센 성수점,26,26,0,100.0,0.0
원기옥,26,25,1,96.2,3.8
심야의 숲,26,26,0,100.0,0.0
부산밀면,26,25,1,96.2,3.8
아이오쓰리 에이스하이엔드점,26,26,0,100.0,0.0
야페,26,26,0,100.0,0.0
피자니스타 서울숲점,26,26,0,100.0,0.0
늘봄숯불갈비,25,21,4,84.0,16.0
타코마이너,25,24,1,96.0,4.0
이가네양꼬치 성수직영점,25,24,1,96.0,4.0
스텀필즈커피,25,25,0,100.0,0.0
성수일미락,25,20,5,80.0,20.0
파티세리 아모니,25,24,1,96.0,4.0
그믐족발 성수점,25,25,0,100.0,0.0
포메인 서울숲점,25,22,3,88.0,12.0
페를 perle,25,25,0,100.0,0.0
우웨이탕,25,24,1,96.0,4.0
온더,25,25,0,100.0,0.0
윤경,24,24,0,100.0,0.0
르베지왕 성수공간,24,24,0,100.0,0.0
조개도,24,24,0,100.0,0.0
산들김밥,24,23,1,95.8,4.2
뱅글,24,24,0,100.0,0.0
플레이버타운,24,23,1,95.8,4.2
호랑도,24,24,0,100.0,0.0
세광양대창 성수점,24,22,2,91.7,8.3
명국수,24,24,0,100.0,0.0
오와리 본점,24,22,2,91.7,8.3
마르코웤스,24,24,0,100.0,0.0
나이스두잉 버거샵,24,24,0,100.0,0.0
저스트텐동 성수점,24,23,1,95.8,4.2
동구식당,23,22,1,95.7,4.3
삽다리곱창,23,22,1,95.7,4.3
안뜰 생선구이동태대구탕 뚝섬역점,23,23,0,100.0,0.0
앳모스피어,23,23,0,100.0,0.0
프랑스포차,23,22,1,95.7,4.3
스프레이,23,23,0,100.0,0.0
오엔엘,23,21,2,91.3,8.7
스탠드업플리즈바이턴온,23,23,0,100.0,0.0
북촌손만두 성수역점,23,23,0,100.0,0.0
팩피,23,23,0,100.0,0.0
카페 마렐,22,22,0,100.0,0.0
차일디쉬,22,22,0,100.0,0.0
댓길,22,22,0,100.0,0.0
하노이바게트,22,19,3,86.4,13.6
아이오쓰리 성수사거리점,22,22,0,100.0,0.0
커피온리 뚝섬역점,22,22,0,100.0,0.0
토리아에즈,22,22,0,100.0,0.0
럭럭카페,22,22,0,100.0,0.0
페스티발,22,20,2,90.9,9.1
하이라인,22,22,0,100.0,0.0
계월 곰탕,22,22,0,100.0,0.0
그린랩,22,21,1,95.5,4.5
더반 베를린 성수점,22,20,2,90.9,9.1
힘이나는커피생활 성수3호점,22,22,0,100.0,0.0
모퉁이와플,22,22,0,100.0,0.0
업사이드커피 뚝섬점,21,21,0,100.0,0.0
강남교자 뚝섬역점,21,20,1,95.2,4.8
라무진 성수점,21,21,0,100.0,0.0
미도림,21,21,0,100.0,0.0
JAFA Brewery,21,18,3,85.7,14.3
열기,21,21,0,100.0,0.0
전자방,21,16,5,76.2,23.8
쎄콩데live,21,19,2,90.5,9.5
대박낙소 성수점,21,18,3,85.7,14.3
카페베네 성수점,21,21,0,100.0,0.0
빽다방 성수역롯데캐슬점,21,20,1,95.2,4.8
컴오프,21,19,2,90.5,9.5
토라식당,21,20,1,95.2,4.8
일구공 성수 본점,21,20,1,95.2,4.8
숲떡,21,16,5,76.2,23.8
청춘고깃간,21,21,0,100.0,0.0
달구벌반점,21,19,2,90.5,9.5
이랑칼국수,21,21,0,100.0,0.0
완백부대찌개삼겹살 성수낙낙점,21,20,1,95.2,4.8
메종 성수돈,21,20,1,95.2,4.8
델리커리 성수낙낙점,21,20,1,95.2,4.8
성수동 간판없는집,21,20,1,95.2,4.8
성수초밥 성수점,20,17,3,85.0,15.0
칠칠칠,20,20,0,100.0,0.0
오프커피,20,20,0,100.0,0.0
청정옥,20,20,0,100.0,0.0
글레이셔박,20,20,0,100.0,0.0
크리스탈드래곤 성수낙낙점,20,20,0,100.0,0.0
타논55,20,19,1,95.0,5.0
오버도즈도넛앤커피,20,20,0,100.0,0.0
마봉양꼬치 성수점,20,20,0,100.0,0.0
퍼니주,20,20,0,100.0,0.0
커피스미스,20,17,3,85.0,15.0
울림,20,17,3,85.0,15.0
스시이치바,20,20,0,100.0,0.0
밀카페 우프,20,19,1,95.0,5.0
BELOW SEONGSOO,20,19,1,95.0,5.0
다모아뷔페,20,20,0,100.0,0.0
젤라또투유,20,20,0,100.0,0.0
매머드익스프레스 성수우림점,20,20,0,100.0,0.0
24시전주명가콩나물국밥 서울성수점,20,20,0,100.0,0.0
신의한국수본점,19,19,0,100.0,0.0
웨이크앤베이크 성수,19,19,0,100.0,0.0
녹마이,19,19,0,100.0,0.0
투그,19,19,0,100.0,0.0
행복한식당,19,19,0,100.0,0.0
성수찰순대국,19,19,0,100.0,0.0
매머드익스프레스 성수역SKV1점,19,19,0,100.0,0.0
힘냉면록,19,18,1,94.7,5.3
멘야마쯔리 성수점,19,19,0,100.0,0.0
왕돈까스&왕냉면 뚝섬점,19,17,2,89.5,10.5
오발탄 서울숲점,19,19,0,100.0,0.0
제일 참 순대국,19,18,1,94.7,5.3
구펠,19,19,0,100.0,0.0
그레이트커피 서울숲점,19,19,0,100.0,0.0
우디집,19,19,0,100.0,0.0
용이네,19,19,0,100.0,0.0
밤새우리,19,19,0,100.0,0.0
파티세리후르츠,18,18,0,100.0,0.0
퍼틴 성수점,18,16,2,88.9,11.1
더벤티 성수아이에스점,18,17,1,94.4,5.6
후다닭Q 본점,18,17,1,94.4,5.6
스테치,18,17,1,94.4,5.6
외가집,18,17,1,94.4,5.6
방춘리,18,18,0,100.0,0.0
아타리,18,17,1,94.4,5.6
플디 성수점,18,18,0,100.0,0.0
에토프커피 성수,18,18,0,100.0,0.0
스시현,18,18,0,100.0,0.0
제로드,18,18,0,100.0,0.0
우마텐 텐동,18,15,3,83.3,16.7
꼬치상점,18,18,0,100.0,0.0
한냄비,18,15,3,83.3,16.7
오시요거트,18,18,0,100.0,0.0
브루잉 세레모니,17,17,0,100.0,0.0
호호반점 성수낙낙점,17,17,0,100.0,0.0
메시,17,16,1,94.1,5.9
오늘와인한잔 성수가든점,17,17,0,100.0,0.0
연탄불꼼장어,17,17,0,100.0,0.0
라비옹카페,17,15,2,88.2,11.8
파리바게뜨 성수코오롱점,17,17,0,100.0,0.0
이태리차차,17,16,1,94.1,5.9
성일정육식당,17,15,2,88.2,11.8
찐짜솥뚜껑삼겹살갈비,17,15,2,88.2,11.8
해피캔디쿠키,17,17,0,100.0,0.0
달래해장 성수점,17,14,3,82.4,17.6
플래닝샐러드,17,16,1,94.1,5.9
우시야 성수점,17,17,0,100.0,0.0
미락바지락칼국수,17,16,1,94.1,5.9
텐바,17,17,0,100.0,0.0
세븐갈비,17,14,3,82.4,17.6
뚜레쥬르 성수역점,17,16,1,94.1,5.9
역전할머니맥주 성수점,17,14,3,82.4,17.6
교촌치킨 성수1호점,17,16,1,94.1,5.9
성수동꿀꽈배기,17,17,0,100.0,0.0
키베이커리,17,17,0,100.0,0.0
작야,16,15,1,93.8,6.2
땡기면땡비어,16,16,0,100.0,0.0
명가닭한마리,16,16,0,100.0,0.0
마루제면소,16,16,0,100.0,0.0
라온석갈비,16,15,1,93.8,6.2
아웃오브타임,16,16,0,100.0,0.0
경성찹쌀꽈배기 성수역점,16,15,1,93.8,6.2
빅쭌부대찌개 성수점,16,16,0,100.0,0.0
파인와플,16,14,2,87.5,12.5
탐앤탐스 성수1호점,16,14,2,87.5,12.5
샌드카베,16,16,0,100.0,0.0
카페 차 성수점,16,15,1,93.8,6.2
다모토리혼,16,16,0,100.0,0.0
포미래,16,16,0,100.0,0.0
매머드익스프레스 뚝섬역점,16,15,1,93.8,6.2
쑤쑤타이,16,16,0,100.0,0.0
산내골칼국수,16,15,1,93.8,6.2
백정돈공장,16,14,2,87.5,12.5
퍼응언쌀국수,16,15,1,93.8,6.2
이북집 찹쌀순대 성수점,16,10,6,62.5,37.5
담소소사골순대육개장 서울숲점,16,16,0,100.0,0.0
뚝섬포구,16,16,0,100.0,0.0
레드브릭스모크하우스,16,16,0,100.0,0.0
맛차차,15,15,0,100.0,0.0
시원,15,15,0,100.0,0.0
강다짐 삼각김밥 성수점,15,14,1,93.3,6.7
한촌설렁탕 성수뚝도점,15,15,0,100.0,0.0
60계치킨 서울성수점,15,13,2,86.7,13.3
빽다방 성수뚝도점,15,14,1,93.3,6.7
보난자 베이커리,15,14,1,93.3,6.7
퍼멘티드 고스트,15,15,0,100.0,0.0
해밀칼국수&김밥,15,14,1,93.3,6.7
아끄떼 뚜,15,15,0,100.0,0.0
성수아구찜,15,15,0,100.0,0.0
담소소사골순대육개장 성수시그마밸리점,15,11,4,73.3,26.7
서울왕돈까스 성수점,15,14,1,93.3,6.7
성수속향연,15,14,1,93.3,6.7
왕십리정곱창 성수점,15,15,0,100.0,0.0
반상회 성수,15,15,0,100.0,0.0
어묵나라,15,14,1,93.3,6.7
돈앤돈 성수점,15,12,3,80.0,20.0
우리칼국수,15,15,0,100.0,0.0
반포식스 성수점,15,14,1,93.3,6.7
올로,15,15,0,100.0,0.0
카멜커피 7호점,15,15,0,100.0,0.0
김밥천국 성수점,15,14,1,93.3,6.7
파스쿠찌 서울숲점,15,13,2,86.7,13.3
온슬,15,14,1,93.3,6.7
후라이드참잘하는집 성수점,15,15,0,100.0,0.0
어글리크림치즈,14,14,0,100.0,0.0
잭슨피자 성수점,14,14,0,100.0,0.0
곳온니플레이스 성수낙낙,14,14,0,100.0,0.0
누에종,14,14,0,100.0,0.0
도미노피자 서울숲점,14,14,0,100.0,0.0
에이그레이트카페 성수점,14,14,0,100.0,0.0
짬뽕타운,14,12,2,85.7,14.3
사운드 플래닛,14,14,0,100.0,0.0
커피식구 성수센터,14,13,1,92.9,7.1
짬뽕품격,14,11,3,78.6,21.4
남다른본가닭한마리 성수점,14,14,0,100.0,0.0
도죠,14,13,1,92.9,7.1
교대이층집 성수점,14,13,1,92.9,7.1
풍조미역 성수본점,14,13,1,92.9,7.1
생삼겹장수유황오리,14,13,1,92.9,7.1
죽변항,14,14,0,100.0,0.0
비스트로류,14,14,0,100.0,0.0
한경화설렁탕,14,14,0,100.0,0.0
서래왕차돌 뚝섬역점,14,13,1,92.9,7.1
천미향,14,13,1,92.9,7.1
벤투스커피 메가박스성수점,14,13,1,92.9,7.1
밋보어 카페 & 이터리 by 에디션덴마크,13,13,0,100.0,0.0
신사소곱창 성수점,13,10,3,76.9,23.1
포지티브 제로 라운지,13,13,0,100.0,0.0
하오마라,13,13,0,100.0,0.0
성운,13,13,0,100.0,0.0
도쎄멕시칸,13,13,0,100.0,0.0
범바,13,13,0,100.0,0.0
무국적주점 거실,13,12,1,92.3,7.7
성수일구,13,13,0,100.0,0.0
진지방순대국,13,13,0,100.0,0.0
퓨엘커피,13,13,0,100.0,0.0
화로양미,13,13,0,100.0,0.0
천하제일 솥뚜껑,13,11,2,84.6,15.4
높은산,13,11,2,84.6,15.4
오와리 뚝섬점,13,12,1,92.3,7.7
오일장,13,13,0,100.0,0.0
감요,13,13,0,100.0,0.0
구스케이지,13,13,0,100.0,0.0
바다화원 본점,13,13,0,100.0,0.0
신의주순대와쭈꾸미 성수점,13,13,0,100.0,0.0
싹쓰리곱창,13,12,1,92.3,7.7
홍낭자와김도령 성수낙낙점,13,13,0,100.0,0.0
현대옥 서울숲점,13,13,0,100.0,0.0
닭한마리,13,13,0,100.0,0.0
갈랭,13,13,0,100.0,0.0
송담추어탕 서울성수점,13,13,0,100.0,0.0
황금어장,13,13,0,100.0,0.0
르살롱오,13,13,0,100.0,0.0
5스타커피 셀렉트샵 서울숲점,13,12,1,92.3,7.7
메쉬커피,13,12,1,92.3,7.7
업사이드커피 연무장점,13,13,0,100.0,0.0
포보스,13,13,0,100.0,0.0
MYC CAFE,12,11,1,91.7,8.3
희정보감족,12,12,0,100.0,0.0
camouflage coffee,12,12,0,100.0,0.0
카페크라비,12,12,0,100.0,0.0
그린한식뷔페,12,12,0,100.0,0.0
모호인,12,11,1,91.7,8.3
커피식탁,12,11,1,91.7,8.3
교촌치킨 성수역점,12,11,1,91.7,8.3
BBQ치킨 성수2점,12,11,1,91.7,8.3
마이올드포스터,12,12,0,100.0,0.0
소문난성수감자탕,12,10,2,83.3,16.7
광장족발 본가,12,12,0,100.0,0.0
리타르단도,12,12,0,100.0,0.0
이우 다이닝,12,12,0,100.0,0.0
옛골감자탕,12,12,0,100.0,0.0
리브릭,12,12,0,100.0,0.0
카페 투스프링,12,12,0,100.0,0.0
회사식당,12,12,0,100.0,0.0
Salad No.6,12,12,0,100.0,0.0
사흘카레,12,11,1,91.7,8.3
탄스이카부츠,12,11,1,91.7,8.3
치카성수,12,12,0,100.0,0.0
담미온 성수점,12,11,1,91.7,8.3
소안도풍경,12,10,2,83.3,16.7
눈꽃돼지,12,12,0,100.0,0.0
유향소,12,12,0,100.0,0.0
해리커피,12,12,0,100.0,0.0
서울숲쭈꾸미,12,12,0,100.0,0.0
우콘카레,12,12,0,100.0,0.0
뜸들이다 성수점,12,12,0,100.0,0.0
미쁘동 서울숲,12,11,1,91.7,8.3
성수 수집,11,11,0,100.0,0.0
햄찌와베찌 뚝섬점,11,11,0,100.0,0.0
맛닭꼬 뚝섬점,11,10,1,90.9,9.1
행닭바베큐통닭,11,10,1,90.9,9.1
커피기업 서울숲점,11,11,0,100.0,0.0
서울앵무새,11,9,2,81.8,18.2
은빛물결 황금낙지,11,11,0,100.0,0.0
란칼국수,11,10,1,90.9,9.1
현방오백소갈비살 성수점,11,11,0,100.0,0.0
맛닭꼬 성수뚝도점,11,11,0,100.0,0.0
이삭토스트 성수2가점,11,11,0,100.0,0.0
전통숯불꼼장어,11,11,0,100.0,0.0
아오미,11,8,3,72.7,27.3
DYI WORKSHOP,11,11,0,100.0,0.0
매튜 Matthew,11,11,0,100.0,0.0
이월로스터스 성수점,11,11,0,100.0,0.0
뚝섬해물탕,11,11,0,100.0,0.0
예빈당,11,9,2,81.8,18.2
도담순대국 성수본점,11,8,3,72.7,27.3
필살기CAFE,11,11,0,100.0,0.0
노을 1관,11,11,0,100.0,0.0
호미담,11,11,0,100.0,0.0
모멘토브루어스,11,11,0,100.0,0.0
플러드,11,11,0,100.0,0.0
프라이데이무브먼트,11,9,2,81.8,18.2
까사다루아,11,11,0,100.0,0.0
송강제면소,11,11,0,100.0,0.0
대돈집,11,11,0,100.0,0.0
오와리 주막,11,10,1,90.9,9.1
기왕생고기,11,11,0,100.0,0.0
걸작떡볶이치킨 성수점,11,11,0,100.0,0.0
푸라닭 성수1가점,11,11,0,100.0,0.0
수향,11,11,0,100.0,0.0
민정식당 서울숲 직영점,11,8,3,72.7,27.3
진짜배기명태촌 서울성수점,11,11,0,100.0,0.0
쉐프우,10,10,0,100.0,0.0
오부대찌개,10,10,0,100.0,0.0
죽이야기 서울 뚝섬역점,10,10,0,100.0,0.0
본가큰댁설렁탕 성수점,10,10,0,100.0,0.0
뚝배기양평해장국 성수점,10,10,0,100.0,0.0
B1 KITCHEN,10,10,0,100.0,0.0
성수스타우트,10,10,0,100.0,0.0
춘천닭갈비,10,10,0,100.0,0.0
용짜장,10,10,0,100.0,0.0
LAZZO,10,10,0,100.0,0.0
샵아지트,10,10,0,100.0,0.0
호칼국수 성수점,10,10,0,100.0,0.0
밀단지,10,10,0,100.0,0.0
카페조이,10,10,0,100.0,0.0
이탈리안 누들,10,10,0,100.0,0.0
동촌샤브칼국수,10,10,0,100.0,0.0
우야꼬칼국수파전,10,10,0,100.0,0.0
밀본 본점,10,8,2,80.0,20.0
큰맘할매순대국 성수동점,10,10,0,100.0,0.0
성수부두,10,10,0,100.0,0.0
제일,10,8,2,80.0,20.0
역삼칼국수,10,10,0,100.0,0.0
김밥 어때,10,10,0,100.0,0.0
일월수제만두,10,10,0,100.0,0.0
바오 서울,10,10,0,100.0,0.0
삼미냉면칼국수,10,9,1,90.0,10.0
모루타루,10,9,1,90.0,10.0
카페 포제,10,10,0,100.0,0.0
어부가,10,6,4,60.0,40.0
낙타커피로스터스,10,10,0,100.0,0.0
뚝섬김밥,10,10,0,100.0,0.0
네네치킨 성수2가점,10,9,1,90.0,10.0
김가네김밥 성수시그마밸리점,10,8,2,80.0,20.0
수제양정순대국 본점,10,9,1,90.0,10.0
리옹베이커리,10,10,0,100.0,0.0
은식당,10,10,0,100.0,0.0
전통씨래기국밥,10,9,1,90.0,10.0
모므로살롱,10,10,0,100.0,0.0
더즌오이스터 성수,10,9,1,90.0,10.0
카페요아정,10,10,0,100.0,0.0
디스코커피,10,10,0,100.0,0.0
찌마찌마,10,9,1,90.0,10.0
윤돈,10,10,0,100.0,0.0
색다른면,10,9,1,90.0,10.0
태풍순대국,10,10,0,100.0,0.0
진도부대찌개,10,10,0,100.0,0.0
노우노우바운즈,10,9,1,90.0,10.0
본죽 뚝섬점,10,10,0,100.0,0.0
타크,9,9,0,100.0,0.0
글리머,9,9,0,100.0,0.0
성수골목,9,8,1,88.9,11.1
피자파는집 서울성수점,9,9,0,100.0,0.0
반가백암순대,9,9,0,100.0,0.0
라무진 성수카페거리점,9,8,1,88.9,11.1
성수동골룸 서울숲 해산물 포장마차,9,9,0,100.0,0.0
그룬트,9,9,0,100.0,0.0
한서칼국수,9,9,0,100.0,0.0
성수숯불갈비,9,9,0,100.0,0.0
독보,9,8,1,88.9,11.1
마이쥬스 성수낙낙점,9,9,0,100.0,0.0
한끼밥집,9,8,1,88.9,11.1
예바다,9,9,0,100.0,0.0
덕,9,9,0,100.0,0.0
왕짜장,9,8,1,88.9,11.1
리퀴드랩,9,8,1,88.9,11.1
위풍당당족발,9,9,0,100.0,0.0
국일돼지왕갈비생삼겹살,9,8,1,88.9,11.1
비스트로 앤드투투,9,8,1,88.9,11.1
우리동네칼국수,9,9,0,100.0,0.0
장맛손칼국수,9,9,0,100.0,0.0
EZER Coffee,9,9,0,100.0,0.0
성수망치버거,9,9,0,100.0,0.0
착한짜장,9,9,0,100.0,0.0
노랑통닭 성수점,9,9,0,100.0,0.0
세스크멘슬,9,9,0,100.0,0.0
술래감자탕&순대국,9,9,0,100.0,0.0
피읻짜,9,9,0,100.0,0.0
육품,9,9,0,100.0,0.0
소시맥분,9,9,0,100.0,0.0
엉터리생고기 성수점,9,8,1,88.9,11.1
둘둘치킨 뚝섬점,9,9,0,100.0,0.0
칠성옻닭,9,7,2,77.8,22.2
가가호호 성수점,9,9,0,100.0,0.0
피자헛 성수점,9,9,0,100.0,0.0
룰루랄라 뚝섬역점,9,9,0,100.0,0.0
서울맛집,9,9,0,100.0,0.0
가장맛있는족발 뚝섬역점,9,8,1,88.9,11.1
르프리크,9,9,0,100.0,0.0
고기다 성수점,9,9,0,100.0,0.0
미정이네식당,9,8,1,88.9,11.1
오비광장,9,9,0,100.0,0.0
봉짬뽕,9,9,0,100.0,0.0
밀향기,8,8,0,100.0,0.0
성수장,8,8,0,100.0,0.0
청주한씨,8,8,0,100.0,0.0
삼삼이네생고기 성수점,8,7,1,87.5,12.5
참참치킨 성수점,8,7,1,87.5,12.5
심마니약초백숙,8,8,0,100.0,0.0
홍보석,8,8,0,100.0,0.0
영구스피자 성수점,8,8,0,100.0,0.0
청키드 성수점,8,8,0,100.0,0.0
성수찌개,8,8,0,100.0,0.0
복식커피,8,8,0,100.0,0.0
연탄요릿집,8,7,1,87.5,12.5
하남돼지집 성수역점,8,7,1,87.5,12.5
쭈전부리,8,8,0,100.0,0.0
원할머니보쌈족발 성수점,8,8,0,100.0,0.0
원산면옥,8,8,0,100.0,0.0
와인바킥,8,6,2,75.0,25.0
더다미,8,8,0,100.0,0.0
풍년숯불돼지갈비,8,8,0,100.0,0.0
bakery tomo,8,8,0,100.0,0.0
레스카페,8,7,1,87.5,12.5
윤스김밥,8,8,0,100.0,0.0
성수식당,8,8,0,100.0,0.0
컴포즈커피 성수점,8,7,1,87.5,12.5
영식품,8,8,0,100.0,0.0
309디저트카페,8,8,0,100.0,0.0
비놈,8,8,0,100.0,0.0
이키나리돈부리,8,8,0,100.0,0.0
더리터 성수역점,8,7,1,87.5,12.5
언커먼그라운드,8,7,1,87.5,12.5
씨에이크,8,8,0,100.0,0.0
베르두레 성수점,8,8,0,100.0,0.0
카페 스밍 스튜디오,8,8,0,100.0,0.0
밥플러스 에이스하이엔드점,8,8,0,100.0,0.0
카페 스트랏,8,8,0,100.0,0.0
피자스쿨 뚝섬역점,8,8,0,100.0,0.0
서울숲오삼불고기,8,8,0,100.0,0.0
땡초꼼장어,8,8,0,100.0,0.0
엘몰리노,8,8,0,100.0,0.0
커피베이 서울숲AK밸리점,8,8,0,100.0,0.0
호식이두마리치킨 서울숲점,8,8,0,100.0,0.0
풍년식당,8,7,1,87.5,12.5
SooLit,7,7,0,100.0,0.0
민속김밥,7,7,0,100.0,0.0
성수손칼국수,7,7,0,100.0,0.0
넌 꼬막 난 육회,7,5,2,71.4,28.6
쵸리상경,7,7,0,100.0,0.0
햄찌와베찌,7,7,0,100.0,0.0
청죽골 2호점,7,7,0,100.0,0.0
베러로스팅랩&쇼룸,7,7,0,100.0,0.0
구시월닭한마리,7,6,1,85.7,14.3
내추럴,7,7,0,100.0,0.0
하노이별 서울숲점,7,7,0,100.0,0.0
뺌치킨,7,7,0,100.0,0.0
리커버리커피바,7,7,0,100.0,0.0
한남양옥 성수,7,7,0,100.0,0.0
맥스카나,7,7,0,100.0,0.0
밥플러스 아이티캐슬점,7,7,0,100.0,0.0
성수BONE 성수동한우짝갈비,7,7,0,100.0,0.0
스시라온,7,7,0,100.0,0.0
고흥만,7,7,0,100.0,0.0
도토루커피os,7,7,0,100.0,0.0
토끼와거북전,7,6,1,85.7,14.3
소바짐,7,7,0,100.0,0.0
코시나,7,7,0,100.0,0.0
헤이피자,7,7,0,100.0,0.0
부뚜막,7,7,0,100.0,0.0
더킹돈 뚝섬점,7,7,0,100.0,0.0
탕가네,7,7,0,100.0,0.0
훈연,7,7,0,100.0,0.0
생활맥주 성수 한라시그마밸리점,7,7,0,100.0,0.0
성수불타는곱창,7,7,0,100.0,0.0
하이엔드라이,7,5,2,71.4,28.6
시골집,7,6,1,85.7,14.3
도토리편백집 이마트성수점,7,7,0,100.0,0.0
왕분식,7,7,0,100.0,0.0
플라이팬커피 뚝섬점,7,7,0,100.0,0.0
김종욱 커피,7,7,0,100.0,0.0
투다리 뚝섬점,7,7,0,100.0,0.0
창창커피,7,7,0,100.0,0.0
천수곱창,7,6,1,85.7,14.3
꼬꼬스토리 성수점,7,7,0,100.0,0.0
알파카페,7,7,0,100.0,0.0
참숯나라갈비마을,7,6,1,85.7,14.3
하피,7,7,0,100.0,0.0
전주콩나물국밥,7,7,0,100.0,0.0
양평서울해장국큰아들집 성동세무서점,7,7,0,100.0,0.0
삼천만활어횟집,7,7,0,100.0,0.0
장가,7,7,0,100.0,0.0
송범순대국,6,6,0,100.0,0.0
성수동양갈비,6,6,0,100.0,0.0
리브나 Rivna,6,6,0,100.0,0.0
동맛골보쌈칼국수,6,6,0,100.0,0.0
모이크,6,6,0,100.0,0.0
코너룸,6,6,0,100.0,0.0
amado,6,6,0,100.0,0.0
브레드온,6,6,0,100.0,0.0
홍정원,6,6,0,100.0,0.0
앙골로에스프레소,6,6,0,100.0,0.0
예셰숄,6,6,0,100.0,0.0
넘버파이브,6,6,0,100.0,0.0
킴스치킨,6,5,1,83.3,16.7
복닭 성수점,6,6,0,100.0,0.0
모어딥 성수,6,5,1,83.3,16.7
멜드,6,6,0,100.0,0.0
풍년정육점식당,6,6,0,100.0,0.0
더퍼즈,6,6,0,100.0,0.0
제비집,6,6,0,100.0,0.0
에그마카슈 성수,6,6,0,100.0,0.0
박가부대 성수코오롱디지털밸리점,6,6,0,100.0,0.0
호남식당,6,6,0,100.0,0.0
호랑이식탁,6,6,0,100.0,0.0
호타루,6,6,0,100.0,0.0
뚝도지기,6,6,0,100.0,0.0
티핀,6,6,0,100.0,0.0
성수다락,6,6,0,100.0,0.0
전주집,6,6,0,100.0,0.0
성수동꽈배기 로고스타,6,6,0,100.0,0.0
두남자의개수작,6,6,0,100.0,0.0
파파존스 성수점,6,6,0,100.0,0.0
커피코코,6,6,0,100.0,0.0
뚝섬삼겹,6,6,0,100.0,0.0
파치비 성수점,6,5,1,83.3,16.7
로우커피스탠드 성수점,6,6,0,100.0,0.0
맛보래,6,5,1,83.3,16.7
바나나트리 성수점,6,6,0,100.0,0.0
카페 알렛츠,6,6,0,100.0,0.0
서울에스프레소,6,6,0,100.0,0.0
언니커피,6,6,0,100.0,0.0
잔치국수아줌마,6,6,0,100.0,0.0
완산골콩나물국밥,6,6,0,100.0,0.0
수칼국수,6,6,0,100.0,0.0
라성천사,6,6,0,100.0,0.0
카페바로,6,6,0,100.0,0.0
두루치기김치찌개,6,6,0,100.0,0.0
향토칼국수,6,6,0,100.0,0.0
원앤하프,6,6,0,100.0,0.0
소적두 성수점,5,5,0,100.0,0.0
조양생고기순대국,5,4,1,80.0,20.0
일심정,5,4,1,80.0,20.0
홍천숯닭,5,5,0,100.0,0.0
어페어커피,5,4,1,80.0,20.0
목로정원,5,5,0,100.0,0.0
BBQ치킨 성수3점,5,5,0,100.0,0.0
DODODO,5,5,0,100.0,0.0
한세희복집,5,5,0,100.0,0.0
혜성분식,5,5,0,100.0,0.0
앙심품은도야지,5,5,0,100.0,0.0
자매집생선구이,5,4,1,80.0,20.0
제비뽑기,5,5,0,100.0,0.0
카페라니,5,5,0,100.0,0.0
55주막,5,5,0,100.0,0.0
Cafe B&S,5,5,0,100.0,0.0
물레방아민물매운탕,5,5,0,100.0,0.0
미사랑,5,5,0,100.0,0.0
뚝시돈,5,5,0,100.0,0.0
담바골,5,5,0,100.0,0.0
행복식당,5,5,0,100.0,0.0
숲속식사 철판볶음밥,5,5,0,100.0,0.0
인덱스카라멜,5,4,1,80.0,20.0
유진참치,5,5,0,100.0,0.0
맛집이모네,5,5,0,100.0,0.0
쿠시범,5,5,0,100.0,0.0
당도,5,5,0,100.0,0.0
또치 참숯생고기,5,5,0,100.0,0.0
행운호프,5,4,1,80.0,20.0
파라디,5,5,0,100.0,0.0
셀럽드샐러드,5,5,0,100.0,0.0
보끔당 성수점,5,5,0,100.0,0.0
케슬리 본점,5,5,0,100.0,0.0
참나무로 바베큐,5,5,0,100.0,0.0
프로가정식백반,5,5,0,100.0,0.0
해밀칼국수 성수점,5,5,0,100.0,0.0
ONE BEAN카페,5,5,0,100.0,0.0
무근본,5,4,1,80.0,20.0
송가,5,5,0,100.0,0.0
우오보파스타바,5,5,0,100.0,0.0
FINZ 핀즈,5,5,0,100.0,0.0
박가객주,5,5,0,100.0,0.0
제스티살룬성수,5,5,0,100.0,0.0
일미돼지국밥,5,5,0,100.0,0.0
원샷치킨,5,4,1,80.0,20.0
먼치스앤구디스,5,4,1,80.0,20.0
푸라닭 성수2가점,5,5,0,100.0,0.0
성수족발,5,3,2,60.0,40.0
우동가조쿠 성수점,5,5,0,100.0,0.0
종가빈대떡,5,5,0,100.0,0.0
코트사이드,5,4,1,80.0,20.0
셀렉토커피 서울숲IT캐슬점,5,5,0,100.0,0.0
대림창고,5,5,0,100.0,0.0
행운식당,5,5,0,100.0,0.0
오니기리와이규동 성수점,5,5,0,100.0,0.0
원조감자탕,5,5,0,100.0,0.0
코코호도 성수점,5,5,0,100.0,0.0
카페아모렘,5,5,0,100.0,0.0
얼룩,5,5,0,100.0,0.0
씨씨씨,5,5,0,100.0,0.0
과일파는 덕이언니,5,5,0,100.0,0.0
더반푸드,5,5,0,100.0,0.0
얼큰이왕냉면,5,5,0,100.0,0.0
한성식당,5,5,0,100.0,0.0
가마솥추어탕,5,5,0,100.0,0.0
매너커피,5,5,0,100.0,0.0
마포설농탕,5,5,0,100.0,0.0
용싸롱,5,5,0,100.0,0.0
피자스쿨 성수쇼핑센타점,5,5,0,100.0,0.0
꽈배기에 반한 치킨 성수점,4,4,0,100.0,0.0
뚝섬생고기,4,4,0,100.0,0.0
배떡 성수점,4,4,0,100.0,0.0
릴레이션 카페,4,4,0,100.0,0.0
명동할머니국수 성수카페거리점,4,4,0,100.0,0.0
곡성,4,4,0,100.0,0.0
문화식당,4,3,1,75.0,25.0
LOWIDE,4,3,1,75.0,25.0
오프비트,4,4,0,100.0,0.0
야끼도리정,4,4,0,100.0,0.0
어니언성수점,4,4,0,100.0,0.0
밤토리,4,4,0,100.0,0.0
100회,4,3,1,75.0,25.0
신성웰빙족발,4,4,0,100.0,0.0
소소하게,4,4,0,100.0,0.0
쿠켄치킨호프 성수점,4,4,0,100.0,0.0
다미,4,3,1,75.0,25.0
유메이규,4,4,0,100.0,0.0
피카워크샵,4,4,0,100.0,0.0
자금성,4,4,0,100.0,0.0
암암리,4,4,0,100.0,0.0
카페오라,4,4,0,100.0,0.0
도믹스,4,4,0,100.0,0.0
아니마토,4,4,0,100.0,0.0
파주부대찌개,4,4,0,100.0,0.0
써니브레드,4,4,0,100.0,0.0
신신원,4,4,0,100.0,0.0
동호마을명태코다리,4,4,0,100.0,0.0
나나횟집,4,4,0,100.0,0.0
더블핸스테이크 서울숲점,4,4,0,100.0,0.0
성수칼국수,4,4,0,100.0,0.0
블루보틀성수점,4,3,1,75.0,25.0
에이치커피로스터스,4,3,1,75.0,25.0
부덕관,4,4,0,100.0,0.0
비스트리오,4,4,0,100.0,0.0
탕 김치찌개,4,4,0,100.0,0.0
원조장충왕족발,4,4,0,100.0,0.0
양과자점 라보엠,4,4,0,100.0,0.0
정든집,4,4,0,100.0,0.0
밥플러스 6호점,4,4,0,100.0,0.0
스시류블랙 성수낙낙점,4,4,0,100.0,0.0
장흥식당,4,4,0,100.0,0.0
온에떼라,4,3,1,75.0,25.0
피자스쿨 성수점,4,4,0,100.0,0.0
커피베이 성동성수점,4,3,1,75.0,25.0
맞닿음 성수점,4,3,1,75.0,25.0
감닭오구공공,4,4,0,100.0,0.0
화양리우동집,4,4,0,100.0,0.0
2002횟집,4,4,0,100.0,0.0
일루오리,4,4,0,100.0,0.0
독도참치 성수점,4,4,0,100.0,0.0
민물집,4,4,0,100.0,0.0
맛부,4,4,0,100.0,0.0
신명먹거리,3,3,0,100.0,0.0
윕성수,3,3,0,100.0,0.0
Make,3,3,0,100.0,0.0
꾸아,3,3,0,100.0,0.0
젠젠 성수점,3,3,0,100.0,0.0
잇쇼우,3,2,1,66.7,33.3
성수 팍스부대찌개 본점,3,3,0,100.0,0.0
서후와규,3,3,0,100.0,0.0
그레이박스,3,3,0,100.0,0.0
옹근달,3,3,0,100.0,0.0
미각짬뽕양꼬치,3,3,0,100.0,0.0
찐미 숯불구이,3,3,0,100.0,0.0
여기가좋겠네,3,3,0,100.0,0.0
카페랏102,3,3,0,100.0,0.0
코스모스상점,3,3,0,100.0,0.0
별미식당,3,3,0,100.0,0.0
뿐또블루,3,3,0,100.0,0.0
킨더프레스 에스프레소 바 성수뚝섬점,3,3,0,100.0,0.0
호호식당,3,2,1,66.7,33.3
레타주,3,3,0,100.0,0.0
콜렉트,3,3,0,100.0,0.0
윤식당 한식뷔페,3,3,0,100.0,0.0
성수베이킹스튜디오,3,3,0,100.0,0.0
남원콩나물국밥,3,3,0,100.0,0.0
쁘띠그랑,3,3,0,100.0,0.0
하루나,3,3,0,100.0,0.0
매머드익스프레스 서울숲코오롱1차점,3,3,0,100.0,0.0
키보우 라멘,3,3,0,100.0,0.0
다담,3,3,0,100.0,0.0
바탕,3,3,0,100.0,0.0
행복한집,3,3,0,100.0,0.0
투달러스커피,3,3,0,100.0,0.0
시골밥상,3,3,0,100.0,0.0
민티베리,3,3,0,100.0,0.0
퀴바라,3,3,0,100.0,0.0
Naked Coffee,3,3,0,100.0,0.0
차만다서울숲점,3,3,0,100.0,0.0
성수낙지,3,3,0,100.0,0.0
어촌횟집,3,3,0,100.0,0.0
서산식당,3,3,0,100.0,0.0
성수차이나,3,2,1,66.7,33.3
금돼지,3,2,1,66.7,33.3
바위파스타바 성수,3,3,0,100.0,0.0
우영푸드빌,3,3,0,100.0,0.0
엘라,3,3,0,100.0,0.0
착한족발 성수점,3,3,0,100.0,0.0
제주올레포차 2호점,3,3,0,100.0,0.0
꾸이한끼 성수점,3,3,0,100.0,0.0
야곱293,3,3,0,100.0,0.0
진한식부페,3,3,0,100.0,0.0
순심이네생삼겹,3,3,0,100.0,0.0
싱싱횟집,3,3,0,100.0,0.0
빌런,3,3,0,100.0,0.0
후프커피,3,3,0,100.0,0.0
앵무새루이스,3,3,0,100.0,0.0
홍도식당,3,3,0,100.0,0.0
마씨,3,3,0,100.0,0.0
BHC치킨 성수역점,3,3,0,100.0,0.0
순심이네,3,3,0,100.0,0.0
명인갈비 성수점,3,3,0,100.0,0.0
락지,3,3,0,100.0,0.0
압구정샌드위치 성수점,3,2,1,66.7,33.3
오거트,3,3,0,100.0,0.0
옛날순대국밥,3,3,0,100.0,0.0
흙과나무,3,3,0,100.0,0.0
병천순대국 성수점,2,2,0,100.0,0.0
뚝도국수집,2,2,0,100.0,0.0
스몰글라스,2,2,0,100.0,0.0
논스톱샌드위치,2,2,0,100.0,0.0
광주식당,2,2,0,100.0,0.0
살롱드가벵양,2,2,0,100.0,0.0
성연순대국&족발,2,2,0,100.0,0.0
골목집,2,2,0,100.0,0.0
코치,2,2,0,100.0,0.0
88켄터키 성수점,2,2,0,100.0,0.0
브로벨커피,2,2,0,100.0,0.0
더존푸드,2,2,0,100.0,0.0
테이블 소사이어티 클럽,2,2,0,100.0,0.0
조리,2,2,0,100.0,0.0
또와,2,2,0,100.0,0.0
카페수다,2,2,0,100.0,0.0
내고향정육점식당,2,2,0,100.0,0.0
새촌131,2,2,0,100.0,0.0
머니뭐니 성수점,2,2,0,100.0,0.0
할아버지공장,2,2,0,100.0,0.0
굴국밥현이네,2,2,0,100.0,0.0
중앙감속기,2,2,0,100.0,0.0
장수숯불갈비,2,2,0,100.0,0.0
솔솥성수점,2,2,0,100.0,0.0
온량,2,2,0,100.0,0.0
난포,2,1,1,50.0,50.0
비사벌전주콩나물국밥,2,2,0,100.0,0.0
죽고을,2,2,0,100.0,0.0
메이플탑,2,2,0,100.0,0.0
에르제,2,2,0,100.0,0.0
피어커피로스터스,2,2,0,100.0,0.0
백억포차,2,2,0,100.0,0.0
큐리크,2,2,0,100.0,0.0
센터커피,2,2,0,100.0,0.0
스트로베리32,2,2,0,100.0,0.0
카라,2,2,0,100.0,0.0
너랑나랑 콩나물국밥삼겹살,2,2,0,100.0,0.0
정참치,2,2,0,100.0,0.0
어커,2,2,0,100.0,0.0
라스베이글 성수점,2,2,0,100.0,0.0
밥플러스 성수에이팩센터점,2,1,1,50.0,50.0
깡통집,2,2,0,100.0,0.0
소문난생만두 성수역점,2,2,0,100.0,0.0
소나무커피,2,2,0,100.0,0.0
카페온화 본사,2,1,1,50.0,50.0
지수언니,2,2,0,100.0,0.0
이흥부오향족발 뚝섬점,2,1,1,50.0,50.0
춘천닭갈비낙지철판,2,2,0,100.0,0.0
연탄구이집,2,2,0,100.0,0.0
카페일로,2,2,0,100.0,0.0
대성정,2,2,0,100.0,0.0
웰컴차이나,2,2,0,100.0,0.0
써니,2,2,0,100.0,0.0
청수먹거리,2,2,0,100.0,0.0
성수뚝배기,2,2,0,100.0,0.0
루덴스파트너스,2,2,0,100.0,0.0
십삼동,2,2,0,100.0,0.0
신촌설렁탕,2,2,0,100.0,0.0
둘둘치킨 성수1호점,2,2,0,100.0,0.0
강남빈대떡,2,2,0,100.0,0.0
슬로우캘리 뚝섬역점,2,2,0,100.0,0.0
IT 뷔페,2,2,0,100.0,0.0
시골가마솥삼겹살 성수점,2,2,0,100.0,0.0
조프리케이크,2,2,0,100.0,0.0
장위동유성집 성동점,2,2,0,100.0,0.0
레이어57 카페,2,2,0,100.0,0.0
우리집밥,2,2,0,100.0,0.0
어랑횟집,2,2,0,100.0,0.0
장안식당,1,1,0,100.0,0.0
돼지네생삼겹살,1,1,0,100.0,0.0
패티패티,1,1,0,100.0,0.0
포크앤라이프,1,1,0,100.0,0.0
소담닭갈비,1,1,0,100.0,0.0
소랑호젠,1,1,0,100.0,0.0
프레이커피바 PCB서울,1,1,0,100.0,0.0
서울숲이장집,1,1,0,100.0,0.0
조조칼국수 성수점,1,1,0,100.0,0.0
크레송,1,1,0,100.0,0.0
심토불이,1,1,0,100.0,0.0
코사이어티 서울숲,1,1,0,100.0,0.0
소소한가게,1,1,0,100.0,0.0
병천순대국,1,1,0,100.0,0.0
백야드빌더성수,1,1,0,100.0,0.0
지코바치킨 성수1호점,1,1,0,100.0,0.0
시골옻닭,1,1,0,100.0,0.0
피에스비 커피바,1,1,0,100.0,0.0
카나비스트릿,1,1,0,100.0,0.0
오스테리아쟌니,1,1,0,100.0,0.0
성수부엌,1,1,0,100.0,0.0
코타티 성수점,1,1,0,100.0,0.0
어썸브로시스,1,1,0,100.0,0.0
태백집 성수점,1,1,0,100.0,0.0
멜로워,1,1,0,100.0,0.0
버거점프,1,1,0,100.0,0.0
서울로인서울숲점,1,1,0,100.0,0.0
성수리얼,1,0,1,0.0,100.0
dooop,1,1,0,100.0,0.0
INDICA,1,1,0,100.0,0.0
백두대간 성수점,1,1,0,100.0,0.0
뚝도수산,1,1,0,100.0,0.0
진작다이닝,1,1,0,100.0,0.0
달님이네,1,1,0,100.0,0.0
퀸테트,1,1,0,100.0,0.0
복돼지,1,1,0,100.0,0.0
미엘릿,1,1,0,100.0,0.0
데이앤데이 뚝섬역점,1,1,0,100.0,0.0
마아트 커피 브루어스 2호점,1,1,0,100.0,0.0
YENA,1,1,0,100.0,0.0
밀도,1,1,0,100.0,0.0
쓰리오브어스,1,1,0,100.0,0.0
카페리빈 성수점,1,1,0,100.0,0.0
뺑드에코,1,1,0,100.0,0.0
라일락,1,1,0,100.0,0.0
아크밸리서비스,1,1,0,100.0,0.0
경수식당,1,1,0,100.0,0.0
남경관,1,1,0,100.0,0.0
한강,1,1,0,100.0,0.0
중국관,1,0,1,0.0,100.0
생태한마리,1,1,0,100.0,0.0
레이어10 카페,1,1,0,100.0,0.0
푸른바다횟집,1,1,0,100.0,0.0
우봉산수정,1,1,0,100.0,0.0
단과자,1,1,0,100.0,0.0
오늘도못참치,1,1,0,100.0,0.0
카페 메이,1,1,0,100.0,0.0
호프카톡,1,1,0,100.0,0.0
남매칼국수,1,1,0,100.0,0.0
진수성찬한식뷔페,1,1,0,100.0,0.0
맥문동호프,1,1,0,100.0,0.0
서울리안,1,1,0,100.0,0.0
형제갈비,1,1,0,100.0,0.0
nothingmatters,1,1,0,100.0,0.0
행운한식뷔페,1,1,0,100.0,0.0
순남시래기 서울숲역점,1,1,0,100.0,0.0
제이앤제이펍,1,1,0,100.0,0.0
현심야식당 성수점,1,1,0,100.0,0.0
한끼,1,1,0,100.0,0.0
미정이네코다리찜,1,0,1,0.0,100.0
진국해장국,1,1,0,100.0,0.0
광순네식당,1,1,0,100.0,0.0
본도시락 성수점,1,1,0,100.0,0.0
에이셉피자 성수점,1,1,0,100.0,0.0
음악창고 LP BAR,1,1,0,100.0,0.0
pvglab,1,1,0,100.0,0.0
미리내,1,1,0,100.0,0.0
카페 뮤,1,1,0,100.0,0.0
쥬씨 성수IT점,1,1,0,100.0,0.0
라에비뉴,1,1,0,100.0,0.0
커피사피엔스 성수우림점,1,1,0,100.0,0.0
잇덴굿 성수점,1,1,0,100.0,0.0
아재커피 성수2가점,1,1,0,100.0,0.0
동강,1,1,0,100.0,0.0
얌커피,1,1,0,100.0,0.0
문화공간 성수,1,1,0,100.0,0.0
황기닭한마리,1,1,0,100.0,0.0
하루참치랑연어랑,1,1,0,100.0,0.0
가내수공업고깃집,1,1,0,100.0,0.0
태양각,1,1,0,100.0,0.0
윈야드 성수,1,1,0,100.0,0.0
부성식당,1,1,0,100.0,0.0
니드인,1,1,0,100.0,0.0
비어호프,1,1,0,100.0,0.0
이키가이,1,1,0,100.0,0.0
한돈급냉삼겹살,1,1,0,100.0,0.0
CAFE FLARES,1,1,0,100.0,0.0
울보분식,1,1,0,100.0,0.0
노을 2관,1,1,0,100.0,0.0
푸드갤러리빈,1,1,0,100.0,0.0
커피사피엔스 선명스퀘어점,1,1,0,100.0,0.0
빨간마초닭발 성수점,1,1,0,100.0,0.0
