호텔,리뷰 개수,긍정 리뷰 개수,부정 리뷰 개수,긍정 리뷰 비율,부정 리뷰 비율
노가리마켓 서울숲,396,392,4,99.0,1.0
고든램지 스트리트 피자 서울숲점,221,198,23,89.6,10.4
오마카세 오사이초밥 성수점,204,203,1,99.5,0.5
아파스타먼,196,195,1,99.5,0.5
쎄콩데live,182,178,4,97.8,2.2
젠젠 성수점,181,177,4,97.8,2.2
두 투리에,173,173,0,100.0,0.0
마씨,171,171,0,100.0,0.0
구욱희씨 서울숲점,170,166,4,97.6,2.4
누데이크 성수점,153,142,11,92.8,7.2
노이,145,143,2,98.6,1.4
호루몬규상,141,140,1,99.3,0.7
성수이루다,141,139,2,98.6,1.4
테니,138,131,7,94.9,5.1
도치피자 성수,137,137,0,100.0,0.0
크림라벨 서울숲 본점,134,129,5,96.3,3.7
브리비트,129,129,0,100.0,0.0
권식족발 성수본점,124,124,0,100.0,0.0
파머스카페,123,120,3,97.6,2.4
로우커피스탠드,119,119,0,100.0,0.0
조조칼국수 성수점,119,117,2,98.3,1.7
스케줄 성수,114,108,6,94.7,5.3
크리스탈드래곤 성수낙낙점,111,111,0,100.0,0.0
보끔당 성수점,106,106,0,100.0,0.0
핫쵸 성수점,106,100,6,94.3,5.7
신사소곱창 성수점,105,104,1,99.0,1.0
퍼먼트,104,101,3,97.1,2.9
메종 파이프그라운드,102,99,3,97.1,2.9
고집132 성수본점,101,98,3,97.0,3.0
투파인드피터 서울성수점,100,99,1,99.0,1.0
해밀칼국수&김밥,100,97,3,97.0,3.0
테디스오븐,99,97,2,98.0,2.0
쿠키도우즈,97,96,1,99.0,1.0
앤드밀 성수점,96,90,6,93.8,6.2
비스트리오,96,95,1,99.0,1.0
로우키,94,92,2,97.9,2.1
르프리크,94,92,2,97.9,2.1
후라토식당 성수점,91,90,1,98.9,1.1
맘스터치 성수역점,91,82,9,90.1,9.9
오와리 본점,90,89,1,98.9,1.1
도도한면 성수본점,90,88,2,97.8,2.2
써브웨이 성수역점,90,82,8,91.1,8.9
이키가이,88,87,1,98.9,1.1
청키드 성수점,87,85,2,97.7,2.3
연남토마 성수점,86,81,5,94.2,5.8
윤경양식당,85,79,6,92.9,7.1
보마켓 서울숲점,84,81,3,96.4,3.6
올댓커피 포레스트점,84,80,4,95.2,4.8
홍콩반점0410 성수역점,84,81,3,96.4,3.6
모센즈스위트 성수점,84,83,1,98.8,1.2
브레디포스트 성수,83,79,4,95.2,4.8
비트랩,83,80,3,96.4,3.6
카멜커피 7호점,83,80,3,96.4,3.6
에이투비 Cafe&Bar,83,81,2,97.6,2.4
칙피스 성수점,81,79,2,97.5,2.5
오우드 성수2호점,81,78,3,96.3,3.7
이오로비스트로,80,79,1,98.8,1.2
잇샐러드 성수점,79,78,1,98.7,1.3
하이라인,79,77,2,97.5,2.5
갓잇 성수 홀리워터점,78,77,1,98.7,1.3
메종드마가레뜨,77,74,3,96.1,3.9
망티커피 성수점,76,74,2,97.4,2.6
서울바나나,75,71,4,94.7,5.3
천상가옥,75,75,0,100.0,0.0
시드니김치찜 뚝섬점,75,75,0,100.0,0.0
라무라 성수,75,75,0,100.0,0.0
성수정원,74,74,0,100.0,0.0
카린지_린가네 스낵바,74,68,6,91.9,8.1
훼미리손칼국수보쌈,73,68,5,93.2,6.8
성수옥아궁지 성수본점,72,71,1,98.6,1.4
훈연,71,63,8,88.7,11.3
롯데리아 성수역점,71,68,3,95.8,4.2
화화담 성수,71,66,5,93.0,7.0
타이거풀,71,70,1,98.6,1.4
기후,70,70,0,100.0,0.0
써브웨이 서울숲점,69,62,7,89.9,10.1
계월 곰탕,67,65,2,97.0,3.0
엘더버거,67,59,8,88.1,11.9
쎈느Scene,67,65,2,97.0,3.0
꽌코이,67,61,6,91.0,9.0
더반 베를린 성수점,67,60,7,89.6,10.4
긴밤,66,66,0,100.0,0.0
다포케 성수점,65,61,4,93.8,6.2
그리노 성수,65,65,0,100.0,0.0
포어플랜,65,64,1,98.5,1.5
팔각도 성수역점,65,65,0,100.0,0.0
성수옥상,65,62,3,95.4,4.6
베티버 성수,64,62,2,96.9,3.1
오와리 뚝섬점,64,63,1,98.4,1.6
씨장,63,61,2,96.8,3.2
산들김밥,63,61,2,96.8,3.2
누메로도스,63,63,0,100.0,0.0
강남면옥 성수점,62,61,1,98.4,1.6
탄스이카부츠,62,62,0,100.0,0.0
대성갈비,62,58,4,93.5,6.5
위드번,62,61,1,98.4,1.6
하노이102,62,61,1,98.4,1.6
도렐 성수점,62,61,1,98.4,1.6
아니마토,61,61,0,100.0,0.0
스시메이 성수점,61,60,1,98.4,1.6
무브모브 성수,61,60,1,98.4,1.6
수백당 성수점,61,60,1,98.4,1.6
성수노루,61,57,4,93.4,6.6
미도인 성수,61,59,2,96.7,3.3
오우드 성수1호점,60,59,1,98.3,1.7
가조쿠,60,57,3,95.0,5.0
훔볼트,60,59,1,98.3,1.7
오근내7닭갈비,60,59,1,98.3,1.7
사람사는 고깃집 김일도 성수점,60,57,3,95.0,5.0
미쁘동 서울숲,60,59,1,98.3,1.7
카카모루 성수점,59,58,1,98.3,1.7
뚝도살롱,59,58,1,98.3,1.7
밸런스포케 서울숲점,59,58,1,98.3,1.7
투썸플레이스 성수skv타워점,58,55,3,94.8,5.2
벱,58,56,2,96.6,3.4
무식당 성수본점,58,56,2,96.6,3.4
리얼월드 성수,58,58,0,100.0,0.0
메가MGC커피 성수일로점,58,56,2,96.6,3.4
천하제일 솥뚜껑,58,56,2,96.6,3.4
시슬러스,58,58,0,100.0,0.0
바이레인,57,57,0,100.0,0.0
일일향 성수10호점,57,50,7,87.7,12.3
정돈 성수점,57,56,1,98.2,1.8
오프트,56,54,2,96.4,3.6
꿉당 성수점,56,56,0,100.0,0.0
동빙고 성수점,56,49,7,87.5,12.5
할머니의 레시피,56,55,1,98.2,1.8
풍조미역 성수본점,56,56,0,100.0,0.0
오스테리아 파로,55,54,1,98.2,1.8
잠수교집 성수 직영점,55,48,7,87.3,12.7
오늘와인한잔 성수가든점,55,52,3,94.5,5.5
메가MGC커피 서울숲역점,54,48,6,88.9,11.1
예빈당,54,54,0,100.0,0.0
노모어피자 서울숲점,54,53,1,98.1,1.9
소코아 뚝섬점,54,54,0,100.0,0.0
힘이나는커피생활 성수2호점,53,52,1,98.1,1.9
멘야코노하 성수,53,53,0,100.0,0.0
평이담백뼈칼국수 성수점,52,49,3,94.2,5.8
bd버거 성수,52,52,0,100.0,0.0
포도젝트,52,51,1,98.1,1.9
쿠나,52,48,4,92.3,7.7
성수온실,52,49,3,94.2,5.8
다운타우너 성수 피치스,52,51,1,98.1,1.9
달래해장 성수점,51,47,4,92.2,7.8
마리오네,51,48,3,94.1,5.9
쿠키샾,51,50,1,98.0,2.0
시즈니,51,51,0,100.0,0.0
에이돈,51,51,0,100.0,0.0
"밤의, 와인테라스&낮의, 피자테라스",51,51,0,100.0,0.0
누에종,50,49,1,98.0,2.0
레이더,50,43,7,86.0,14.0
제제,50,48,2,96.0,4.0
프롤라,50,50,0,100.0,0.0
글로우,50,49,1,98.0,2.0
목금,50,47,3,94.0,6.0
아카이브 서울,50,50,0,100.0,0.0
마하차이 서울숲점,49,48,1,98.0,2.0
본말감자탕 뚝섬역점,49,40,9,81.6,18.4
밥밥디라라 뚝섬역점,49,49,0,100.0,0.0
빠오즈푸 서울숲직영점,49,49,0,100.0,0.0
201호,49,49,0,100.0,0.0
팜티진쌀국수,49,48,1,98.0,2.0
세디치,49,48,1,98.0,2.0
데우스 카페 성수점,48,47,1,97.9,2.1
까치화방 성수낙낙점,48,48,0,100.0,0.0
대낚식당,48,44,4,91.7,8.3
본노엘 성수점,48,45,3,93.8,6.2
까망,48,48,0,100.0,0.0
어라운드데이,48,48,0,100.0,0.0
리틀바잇모어,47,47,0,100.0,0.0
카멜커피 성수점,47,42,5,89.4,10.6
만학,47,45,2,95.7,4.3
도죠,47,45,2,95.7,4.3
왕삼겹정육식당,47,47,0,100.0,0.0
하프커피 성수,47,45,2,95.7,4.3
니드스윗,46,45,1,97.8,2.2
슈퍼말차 성수,46,41,5,89.1,10.9
칼,46,46,0,100.0,0.0
헤비스테이크 성수점,46,43,3,93.5,6.5
네번째집,46,45,1,97.8,2.2
커피로 그리는 꿈,46,45,1,97.8,2.2
강호연파 성수 숲속산장점,45,44,1,97.8,2.2
투데이즈이너프,45,45,0,100.0,0.0
브라운래빗 서울숲점,45,43,2,95.6,4.4
문츠 바베큐,45,43,2,95.6,4.4
단일서울,44,44,0,100.0,0.0
페이퍼 플레이트,44,44,0,100.0,0.0
위스위츠,44,43,1,97.7,2.3
메시,43,42,1,97.7,2.3
중화카츠 서울숲,43,43,0,100.0,0.0
원기옥,43,41,2,95.3,4.7
스윗바이브,43,43,0,100.0,0.0
금금 성수점,43,41,2,95.3,4.7
삼선회사랑 뚝섬점,43,42,1,97.7,2.3
록멘,43,41,2,95.3,4.7
펌킨 펫하우스 서울숲,43,43,0,100.0,0.0
뚝도농원,43,42,1,97.7,2.3
패티패티,42,41,1,97.6,2.4
피키니키 라자냐,42,41,1,97.6,2.4
더블해피니스 성수,42,41,1,97.6,2.4
어퍼룸,42,42,0,100.0,0.0
토라식당,42,41,1,97.6,2.4
성수삐딱,42,37,5,88.1,11.9
버거보이 성수낙낙점,42,39,3,92.9,7.1
오와리 주막,42,42,0,100.0,0.0
부우이,42,40,2,95.2,4.8
럭럭카페,41,41,0,100.0,0.0
홍화돈,41,40,1,97.6,2.4
공차 서울숲점,41,35,6,85.4,14.6
아키야마,41,41,0,100.0,0.0
시옹마오,41,40,1,97.6,2.4
컴포즈커피 화양사거리점,41,41,0,100.0,0.0
오레노카츠 성수본점,41,40,1,97.6,2.4
하우트제곱,41,41,0,100.0,0.0
포맨스,41,38,3,92.7,7.3
패티앤베지스 성수,41,41,0,100.0,0.0
에피타이트,41,40,1,97.6,2.4
소인수서울 본점,41,41,0,100.0,0.0
뚝 다이닝,40,37,3,92.5,7.5
서울숲누룽지통닭구이,40,38,2,95.0,5.0
스텀필즈커피,40,40,0,100.0,0.0
마르코웤스,40,38,2,95.0,5.0
성수우동,40,40,0,100.0,0.0
빽다방 화양사거리점,40,39,1,97.5,2.5
계모임,40,38,2,95.0,5.0
오우도,40,40,0,100.0,0.0
신의한국수본점,40,40,0,100.0,0.0
효자동목고기,39,37,2,94.9,5.1
전자방,39,37,2,94.9,5.1
힘이나는커피생활 성수3호점,39,38,1,97.4,2.6
롸카두들 내쉬빌 핫치킨 성수점,39,38,1,97.4,2.6
어묵나라,39,37,2,94.9,5.1
보스코 에스프레소 바,39,38,1,97.4,2.6
린,39,39,0,100.0,0.0
조디악,39,39,0,100.0,0.0
비스트로성수,39,39,0,100.0,0.0
춘하추우동,38,38,0,100.0,0.0
ERN,38,38,0,100.0,0.0
무탈 성수점,38,37,1,97.4,2.6
세밀,38,38,0,100.0,0.0
빽다방 뚝섬역점,38,38,0,100.0,0.0
호랑이 초밥,38,36,2,94.7,5.3
라에비뉴,38,37,1,97.4,2.6
필살기CAFE,38,38,0,100.0,0.0
티룸,38,34,4,89.5,10.5
BNHR,37,36,1,97.3,2.7
지우관,37,37,0,100.0,0.0
현심야식당 성수점,37,37,0,100.0,0.0
삼옥,37,36,1,97.3,2.7
남다른본가닭한마리 성수점,37,37,0,100.0,0.0
파리바게뜨 성수코오롱점,37,37,0,100.0,0.0
아울림,37,36,1,97.3,2.7
모모야 성수점,37,36,1,97.3,2.7
블루너리,36,35,1,97.2,2.8
하오마라,36,35,1,97.2,2.8
멘야마쯔리 성수점,36,33,3,91.7,8.3
비파서울,36,36,0,100.0,0.0
유스트레스,36,36,0,100.0,0.0
치카성수,36,36,0,100.0,0.0
발렁스,36,35,1,97.2,2.8
24시전주명가콩나물국밥 서울성수점,36,36,0,100.0,0.0
버섯집,35,34,1,97.1,2.9
에빠,35,35,0,100.0,0.0
소년식당,35,35,0,100.0,0.0
누아흐,35,35,0,100.0,0.0
한음,35,33,2,94.3,5.7
델리커리 성수낙낙점,35,33,2,94.3,5.7
pdbb,35,34,1,97.1,2.9
구아바,35,35,0,100.0,0.0
더벤티 성수카페거리점,35,35,0,100.0,0.0
슈에뜨펍,35,34,1,97.1,2.9
청담순대국,35,35,0,100.0,0.0
디플랫 성수,35,35,0,100.0,0.0
화이트글래스,35,35,0,100.0,0.0
왕짜장,35,35,0,100.0,0.0
어피스앤드피스,35,35,0,100.0,0.0
제비뽑기,34,34,0,100.0,0.0
문득,34,34,0,100.0,0.0
더카페 서울숲역점,34,32,2,94.1,5.9
플디 성수점,34,32,2,94.1,5.9
기러기둥지 성수,34,33,1,97.1,2.9
감도 성수점,33,32,1,97.0,3.0
짬뽕품격,33,31,2,93.9,6.1
르셀,33,33,0,100.0,0.0
스시오오모토,33,32,1,97.0,3.0
어묵나라 뚝섬점,33,32,1,97.0,3.0
라프레플루트,33,32,1,97.0,3.0
온센 성수점,32,31,1,96.9,3.1
당도,32,31,1,96.9,3.1
Pauline CoffeeBar,32,32,0,100.0,0.0
일호빵,32,32,0,100.0,0.0
타논55,32,31,1,96.9,3.1
마하차이 성수본점,32,30,2,93.8,6.2
소바마에,32,31,1,96.9,3.1
매머드익스프레스 성수역점,32,31,1,96.9,3.1
강남교자 뚝섬역점,32,30,2,93.8,6.2
뚜레쥬르 성수역점,32,30,2,93.8,6.2
이가네양꼬치 성수직영점,31,30,1,96.8,3.2
탐앤탐스 성수1호점,31,31,0,100.0,0.0
파티세리후르츠,31,30,1,96.8,3.2
포동푸딩,31,30,1,96.8,3.2
고기다 성수점,31,31,0,100.0,0.0
마크69,31,28,3,90.3,9.7
명국수,30,30,0,100.0,0.0
꼬모윤 성수,30,28,2,93.3,6.7
stdo,30,28,2,93.3,6.7
성수김밥 퍼니텅,30,29,1,96.7,3.3
루디먼트,30,30,0,100.0,0.0
컴오프,30,28,2,93.3,6.7
파르코,30,29,1,96.7,3.3
반포식스 성수점,30,27,3,90.0,10.0
오토김밥 서울숲점,30,27,3,90.0,10.0
춘배버거,30,30,0,100.0,0.0
용이네,30,27,3,90.0,10.0
카페&펍 연무장,30,29,1,96.7,3.3
래뮤,30,29,1,96.7,3.3
브루잉 세레모니,30,28,2,93.3,6.7
꼬치상점,30,28,2,93.3,6.7
공차 성수역점,30,28,2,93.3,6.7
정선부뚜막,30,28,2,93.3,6.7
스시류블랙 성수낙낙점,30,30,0,100.0,0.0
누메로뜨레쓰,30,29,1,96.7,3.3
희릿,30,30,0,100.0,0.0
구펠,29,28,1,96.6,3.4
글루,29,29,0,100.0,0.0
키베이커리,29,29,0,100.0,0.0
기미사 성수,29,26,3,89.7,10.3
오늘애김밥 성수역점,29,28,1,96.6,3.4
북촌손만두 성수역점,29,28,1,96.6,3.4
아후 Ahoo,29,29,0,100.0,0.0
매머드익스프레스 뚝섬역점,29,28,1,96.6,3.4
탕화쿵푸마라탕 성수동지점,29,28,1,96.6,3.4
신선식탁 성수역점,28,28,0,100.0,0.0
마봉양꼬치 성수점,28,27,1,96.4,3.6
슬로우캘리 뚝섬역점,28,27,1,96.4,3.6
모르므로,28,28,0,100.0,0.0
성일식당아들네,28,28,0,100.0,0.0
토리아에즈,28,26,2,92.9,7.1
나누리잡화점,28,28,0,100.0,0.0
포배럴카페,28,27,1,96.4,3.6
신사동 벼락집,28,28,0,100.0,0.0
칠칠칠,28,28,0,100.0,0.0
벨라스가든 서울숲점,28,27,1,96.4,3.6
타코마이너,28,28,0,100.0,0.0
녹마이,27,27,0,100.0,0.0
체다앤올리,27,25,2,92.6,7.4
에이셉피자 성수점,27,27,0,100.0,0.0
캐주얼성수,27,27,0,100.0,0.0
바르다김선생 서울숲점,27,19,8,70.4,29.6
오버도즈도넛앤커피,27,25,2,92.6,7.4
HDD피자,27,26,1,96.3,3.7
마이쥬스 성수낙낙점,27,27,0,100.0,0.0
BELOW SEONGSOO,27,25,2,92.6,7.4
나미 곰식당,27,27,0,100.0,0.0
폴인레미유 성수점,27,26,1,96.3,3.7
청정옥,27,25,2,92.6,7.4
곤카츠 GONKATSU,27,27,0,100.0,0.0
아이오쓰리 에이스하이엔드점,26,25,1,96.2,3.8
동구식당,26,26,0,100.0,0.0
매머드익스프레스 서울숲코오롱1차점,26,25,1,96.2,3.8
엘레멘츠,26,26,0,100.0,0.0
고운 돈카츠,26,26,0,100.0,0.0
우웨이탕,26,26,0,100.0,0.0
뚝배기양평해장국 성수점,26,26,0,100.0,0.0
미아논나,26,25,1,96.2,3.8
혁신풍천민물장어 서울숲점,26,25,1,96.2,3.8
후라이드참잘하는집 성수점,26,26,0,100.0,0.0
성수동 리얼 로스팅 커피&디저트,26,25,1,96.2,3.8
우시야 성수점,26,26,0,100.0,0.0
업사이드커피,26,26,0,100.0,0.0
카페 포제,26,25,1,96.2,3.8
신라다랑원 성수점,25,25,0,100.0,0.0
샹도르본사직영점,25,25,0,100.0,0.0
티케,25,24,1,96.0,4.0
다모토리혼,25,24,1,96.0,4.0
빽다방 성수뚝도점,25,24,1,96.0,4.0
르베지왕 성수공간,25,24,1,96.0,4.0
백정돈공장,25,21,4,84.0,16.0
토마토김밥 뚝섬역점,25,24,1,96.0,4.0
등촌샤브칼국수 성수점,25,20,5,80.0,20.0
캐스터네츠 서울숲점,25,25,0,100.0,0.0
묘사서울,25,23,2,92.0,8.0
해리커피,25,25,0,100.0,0.0
퀴버 서울숲,25,25,0,100.0,0.0
유가츠,25,25,0,100.0,0.0
착한짜장,25,24,1,96.0,4.0
어메이징브루잉컴퍼니,25,24,1,96.0,4.0
동대문엽기떡볶이 성수점,24,24,0,100.0,0.0
플로피,24,23,1,95.8,4.2
샐러디 성수점,24,22,2,91.7,8.3
스태거,24,24,0,100.0,0.0
돈앤돈 성수점,24,16,8,66.7,33.3
ONE BEAN카페,24,24,0,100.0,0.0
윤경,24,23,1,95.8,4.2
성수시루,24,24,0,100.0,0.0
성일정육식당,24,23,1,95.8,4.2
타치노미바이토라,24,23,1,95.8,4.2
다로베,23,22,1,95.7,4.3
미도림,23,23,0,100.0,0.0
투그,23,23,0,100.0,0.0
이랑칼국수,23,23,0,100.0,0.0
차이나플레인 서울숲점,23,21,2,91.3,8.7
버틀러,23,23,0,100.0,0.0
마루제면소,23,23,0,100.0,0.0
뜨리에이치,23,23,0,100.0,0.0
굿갓레스토랑 성수역점,23,23,0,100.0,0.0
성수일미락,23,20,3,87.0,13.0
배치원 위스키펍,23,23,0,100.0,0.0
무국적주점 거실,23,23,0,100.0,0.0
저스트텐동 성수점,23,23,0,100.0,0.0
회사식당,23,23,0,100.0,0.0
카페요아정,23,21,2,91.3,8.7
조개도,23,23,0,100.0,0.0
외가집,23,23,0,100.0,0.0
유어네이키드치즈,23,22,1,95.7,4.3
리틀포레스트,22,21,1,95.5,4.5
곡성,22,22,0,100.0,0.0
미오 도쿄 다이닝,22,22,0,100.0,0.0
"여기 런던 Here, london",22,22,0,100.0,0.0
이북집 찹쌀순대 성수점,22,19,3,86.4,13.6
팩피,22,22,0,100.0,0.0
짬뽕위에더짬뽕,22,21,1,95.5,4.5
미엘릿,22,19,3,86.4,13.6
빽다방 성수역롯데캐슬점,22,21,1,95.5,4.5
오부대찌개,22,22,0,100.0,0.0
울림,22,21,1,95.5,4.5
푸드갤러리빈,22,21,1,95.5,4.5
성수피글렛,22,22,0,100.0,0.0
홍낭자와김도령 성수낙낙점,22,20,2,90.9,9.1
완백부대찌개삼겹살 성수낙낙점,22,22,0,100.0,0.0
매튜 Matthew,21,20,1,95.2,4.8
유니드카페,21,21,0,100.0,0.0
뚝섬포구,21,21,0,100.0,0.0
봉봉디저트카페,21,20,1,95.2,4.8
아는 커피,21,21,0,100.0,0.0
왕십리정곱창 성수점,21,21,0,100.0,0.0
라무진 성수점,21,20,1,95.2,4.8
경성찹쌀꽈배기 성수역점,21,21,0,100.0,0.0
킴스치킨,21,21,0,100.0,0.0
술래감자탕&순대국,21,21,0,100.0,0.0
비스트로류,21,21,0,100.0,0.0
무근본,21,18,3,85.7,14.3
봉쥬르,21,21,0,100.0,0.0
레스카페,21,20,1,95.2,4.8
성수부두,21,21,0,100.0,0.0
마구로쇼쿠도,21,20,1,95.2,4.8
스테치,21,21,0,100.0,0.0
멜라 성수점,21,21,0,100.0,0.0
에이드티,21,21,0,100.0,0.0
싹쓰리곱창,20,20,0,100.0,0.0
바인,20,20,0,100.0,0.0
성수속향연,20,19,1,95.0,5.0
달구벌반점,20,20,0,100.0,0.0
스프레이,20,19,1,95.0,5.0
강다짐 삼각김밥 성수점,20,20,0,100.0,0.0
카페베네 성수점,20,20,0,100.0,0.0
성수완탕,20,20,0,100.0,0.0
camouflage coffee,20,20,0,100.0,0.0
밤토리,20,20,0,100.0,0.0
성수 수집,20,19,1,95.0,5.0
IT 뷔페,20,16,4,80.0,20.0
성수로운,20,20,0,100.0,0.0
올로,20,19,1,95.0,5.0
이우 다이닝,20,17,3,85.0,15.0
업사이드커피 뚝섬점,20,20,0,100.0,0.0
컴포즈커피 성수점,19,18,1,94.7,5.3
노을 1관,19,17,2,89.5,10.5
도쎄멕시칸,19,19,0,100.0,0.0
버니타운,19,19,0,100.0,0.0
까까를로,19,19,0,100.0,0.0
화포식당성수,19,16,3,84.2,15.8
이로우,19,19,0,100.0,0.0
감요,19,19,0,100.0,0.0
마이올드포스터,19,19,0,100.0,0.0
일심정,19,19,0,100.0,0.0
도담순대국 성수본점,19,19,0,100.0,0.0
인치스,19,19,0,100.0,0.0
진도부대찌개,19,18,1,94.7,5.3
원스카페,19,19,0,100.0,0.0
헬렐레,19,19,0,100.0,0.0
타크,19,19,0,100.0,0.0
아비꼬 성수역점,19,16,3,84.2,15.8
독도사랑 막회,19,19,0,100.0,0.0
교촌치킨 성수역점,19,19,0,100.0,0.0
퍼틴 성수점,19,17,2,89.5,10.5
육품,19,19,0,100.0,0.0
꼬꼬스토리 성수점,19,19,0,100.0,0.0
포지티브 서울숲,19,18,1,94.7,5.3
세광양대창 성수점,19,19,0,100.0,0.0
호우정,18,18,0,100.0,0.0
앳이즈,18,18,0,100.0,0.0
피리어드,18,18,0,100.0,0.0
퍼응언쌀국수,18,18,0,100.0,0.0
호칼국수 성수점,18,18,0,100.0,0.0
엑스익스프레스 성수낙낙점,18,16,2,88.9,11.1
그린한식뷔페,18,18,0,100.0,0.0
민정식당 서울숲 직영점,18,17,1,94.4,5.6
순남시래기 서울숲역점,18,18,0,100.0,0.0
수제양정순대국 본점,18,18,0,100.0,0.0
스시이치바,18,18,0,100.0,0.0
부산밀면,18,18,0,100.0,0.0
더즌오이스터 성수,18,18,0,100.0,0.0
곳온니플레이스 성수낙낙,18,17,1,94.4,5.6
란돌프서울숲,18,18,0,100.0,0.0
맞닿음 성수점,18,17,1,94.4,5.6
담소소사골순대육개장 서울숲점,18,18,0,100.0,0.0
이월로스터스 성수점,18,18,0,100.0,0.0
오발탄 서울숲점,18,17,1,94.4,5.6
도토루커피os,18,18,0,100.0,0.0
써니눅,18,18,0,100.0,0.0
하늘분식,18,18,0,100.0,0.0
수원원조갈비,18,16,2,88.9,11.1
호미담,18,18,0,100.0,0.0
복식커피,17,17,0,100.0,0.0
매머드익스프레스 성수우림점,17,16,1,94.1,5.9
담미온 성수점,17,16,1,94.1,5.9
데이앤데이 뚝섬역점,17,16,1,94.1,5.9
플레이버타운,17,16,1,94.1,5.9
야드 서울,17,17,0,100.0,0.0
죽이야기 서울 뚝섬역점,17,16,1,94.1,5.9
일구공 성수 본점,17,15,2,88.2,11.8
고공 성수본점,17,17,0,100.0,0.0
하노이별 서울숲점,17,17,0,100.0,0.0
더반푸드,17,17,0,100.0,0.0
서래왕차돌 뚝섬역점,17,16,1,94.1,5.9
업사이드커피 연무장점,17,16,1,94.1,5.9
성수동꿀꽈배기,17,17,0,100.0,0.0
라비옹카페,17,17,0,100.0,0.0
안뜰 생선구이동태대구탕 뚝섬역점,17,16,1,94.1,5.9
눈꽃돼지,17,17,0,100.0,0.0
밀본 본점,17,14,3,82.4,17.6
이키나리돈부리,17,17,0,100.0,0.0
그믐족발 성수점,17,15,2,88.2,11.8
아오미,17,16,1,94.1,5.9
제일 참 순대국,17,17,0,100.0,0.0
앳모스피어,17,17,0,100.0,0.0
비도커피,17,16,1,94.1,5.9
삽다리곱창,17,16,1,94.1,5.9
카페 투스프링,17,14,3,82.4,17.6
빙봉,17,16,1,94.1,5.9
보이어,17,17,0,100.0,0.0
차일디쉬,17,17,0,100.0,0.0
우리칼국수,17,17,0,100.0,0.0
오아오아,17,17,0,100.0,0.0
커피사피엔스 선명스퀘어점,16,16,0,100.0,0.0
포미래,16,16,0,100.0,0.0
씩씩 뮤직바,16,16,0,100.0,0.0
피자인,16,16,0,100.0,0.0
송흥,16,16,0,100.0,0.0
피자시즌,16,16,0,100.0,0.0
코트사이드,16,15,1,93.8,6.2
심야의 숲,16,15,1,93.8,6.2
르살롱오,16,15,1,93.8,6.2
왕돈까스&왕냉면 뚝섬점,16,16,0,100.0,0.0
이곳에,16,16,0,100.0,0.0
윤스김밥,16,15,1,93.8,6.2
성수면당,16,16,0,100.0,0.0
성수찰순대국,16,16,0,100.0,0.0
빅쭌부대찌개 성수점,16,16,0,100.0,0.0
높은산,16,16,0,100.0,0.0
김밥천국 성수점,16,15,1,93.8,6.2
샌드카베,16,16,0,100.0,0.0
곱씹어you,16,16,0,100.0,0.0
60계치킨 서울성수점,16,15,1,93.8,6.2
스시현,16,14,2,87.5,12.5
피자스쿨 성수쇼핑센타점,16,16,0,100.0,0.0
커피온리 뚝섬역점,15,14,1,93.3,6.7
호호반점 성수낙낙점,15,15,0,100.0,0.0
성수BONE 성수동한우짝갈비,15,15,0,100.0,0.0
암암리,15,15,0,100.0,0.0
범바,15,15,0,100.0,0.0
에보,15,15,0,100.0,0.0
쑤쑤타이,15,15,0,100.0,0.0
미락바지락칼국수,15,15,0,100.0,0.0
민속김밥,15,15,0,100.0,0.0
본죽 뚝섬점,15,14,1,93.3,6.7
예바다,15,15,0,100.0,0.0
와인쌤마켓 성수낙낙점,15,15,0,100.0,0.0
죽변항,15,15,0,100.0,0.0
성수차이나,15,15,0,100.0,0.0
미디엄스톤 성수점,15,14,1,93.3,6.7
언커먼그라운드,15,14,1,93.3,6.7
찌마찌마,15,14,1,93.3,6.7
마블상회,15,14,1,93.3,6.7
페스티발,15,15,0,100.0,0.0
원앤하프,15,14,1,93.3,6.7
푸르너스가든 서울숲,15,15,0,100.0,0.0
홍보석,15,15,0,100.0,0.0
방춘리,15,14,1,93.3,6.7
성수맥주,15,15,0,100.0,0.0
화로양미,15,15,0,100.0,0.0
모퉁이와플,15,15,0,100.0,0.0
더벤티 성수아이에스점,15,14,1,93.3,6.7
수향,15,15,0,100.0,0.0
샵아지트,15,15,0,100.0,0.0
우콘카레,15,15,0,100.0,0.0
파티세리 아모니,15,13,2,86.7,13.3
닭한마리,15,14,1,93.3,6.7
한끼밥집,15,15,0,100.0,0.0
B1 KITCHEN,15,15,0,100.0,0.0
덕,15,14,1,93.3,6.7
가가호호 성수점,14,14,0,100.0,0.0
매머드익스프레스 성수역SKV1점,14,13,1,92.9,7.1
우마텐 텐동,14,14,0,100.0,0.0
장가,14,14,0,100.0,0.0
성수찌개,14,14,0,100.0,0.0
에토프커피 성수,14,14,0,100.0,0.0
버터컵,14,14,0,100.0,0.0
뚝섬해물탕,14,13,1,92.9,7.1
멜드,14,14,0,100.0,0.0
밋보어 카페 & 이터리 by 에디션덴마크,14,14,0,100.0,0.0
역전할머니맥주 성수점,14,14,0,100.0,0.0
전주콩나물국밥,14,14,0,100.0,0.0
코치,14,13,1,92.9,7.1
메종 성수돈,14,14,0,100.0,0.0
탕 김치찌개,14,14,0,100.0,0.0
햄찌와베찌,14,14,0,100.0,0.0
뚜르띠에르,14,14,0,100.0,0.0
행운식당,14,14,0,100.0,0.0
온더,14,14,0,100.0,0.0
반상회 성수,14,13,1,92.9,7.1
퀸테트,14,14,0,100.0,0.0
늘봄숯불갈비,14,14,0,100.0,0.0
산내골칼국수,14,13,1,92.9,7.1
써니브레드,14,12,2,85.7,14.3
그리너 성수1가점,14,13,1,92.9,7.1
리타르단도,14,14,0,100.0,0.0
한냄비,14,14,0,100.0,0.0
행복한식당,14,13,1,92.9,7.1
보난자 베이커리,14,13,1,92.9,7.1
서울숲쭈꾸미,14,13,1,92.9,7.1
향토칼국수,14,14,0,100.0,0.0
굴림,14,12,2,85.7,14.3
그레이트커피 서울숲점,14,14,0,100.0,0.0
은식당,14,14,0,100.0,0.0
한촌설렁탕 성수뚝도점,13,13,0,100.0,0.0
은빛물결 황금낙지,13,13,0,100.0,0.0
창창커피,13,13,0,100.0,0.0
연탄불꼼장어,13,13,0,100.0,0.0
청춘고깃간,13,11,2,84.6,15.4
현방오백소갈비살 성수점,13,13,0,100.0,0.0
성수아구찜,13,12,1,92.3,7.7
아끄떼 뚜,13,13,0,100.0,0.0
퍼니주,13,13,0,100.0,0.0
오엔엘,13,12,1,92.3,7.7
아타리,13,12,1,92.3,7.7
아재커피 성수2가점,13,13,0,100.0,0.0
성수펍,13,11,2,84.6,15.4
한서칼국수,13,13,0,100.0,0.0
우야꼬칼국수파전,13,12,1,92.3,7.7
바다화원 본점,13,13,0,100.0,0.0
젤라또투유,13,13,0,100.0,0.0
마포설농탕,13,11,2,84.6,15.4
쁘띠 다이너,13,13,0,100.0,0.0
원할머니보쌈족발 성수점,13,13,0,100.0,0.0
맥스카나,13,12,1,92.3,7.7
바오 서울,13,13,0,100.0,0.0
한경화설렁탕,13,12,1,92.3,7.7
잇덴굿 성수점,13,13,0,100.0,0.0
숲떡,13,12,1,92.3,7.7
소시맥분,13,13,0,100.0,0.0
리옹베이커리,13,13,0,100.0,0.0
본가큰댁설렁탕 성수점,13,13,0,100.0,0.0
벼리다,13,12,1,92.3,7.7
비놈,13,13,0,100.0,0.0
리브릭,13,13,0,100.0,0.0
김밥 어때,13,13,0,100.0,0.0
더블하이트 갤러리카페,13,12,1,92.3,7.7
이태리차차,13,13,0,100.0,0.0
아카보시,13,13,0,100.0,0.0
올드너티 커피로스터스,12,12,0,100.0,0.0
쭈전부리,12,12,0,100.0,0.0
프로가정식백반,12,12,0,100.0,0.0
란칼국수,12,12,0,100.0,0.0
퓨엘커피,12,12,0,100.0,0.0
서울왕돈까스 성수점,12,11,1,91.7,8.3
대박낙소 성수점,12,11,1,91.7,8.3
교대이층집 성수점,12,11,1,91.7,8.3
소문난성수감자탕,12,10,2,83.3,16.7
언니커피,12,12,0,100.0,0.0
육육면관,12,12,0,100.0,0.0
피자니스타 서울숲점,12,12,0,100.0,0.0
소바식당,12,11,1,91.7,8.3
히즈빈스 성수점,12,12,0,100.0,0.0
성수동 간판없는집,12,11,1,91.7,8.3
커피사피엔스 성수현대테라스점,12,11,1,91.7,8.3
서울맛집,12,11,1,91.7,8.3
나이스두잉 버거샵,12,12,0,100.0,0.0
어부가,12,11,1,91.7,8.3
MYC CAFE,12,11,1,91.7,8.3
사운드 플래닛,12,10,2,83.3,16.7
매너커피,12,11,1,91.7,8.3
밥플러스 성수에이팩센터점,12,12,0,100.0,0.0
가장맛있는족발 뚝섬역점,12,11,1,91.7,8.3
라온석갈비,12,10,2,83.3,16.7
웜히어,12,11,1,91.7,8.3
생활맥주 성수역1번출구점,12,12,0,100.0,0.0
시원,12,11,1,91.7,8.3
커어피 & 젤라또,12,12,0,100.0,0.0
Salad No.6,12,12,0,100.0,0.0
HBC coffee,12,12,0,100.0,0.0
푸라닭 성수1가점,12,12,0,100.0,0.0
커피식구 성수센터,12,12,0,100.0,0.0
아이오쓰리 성수사거리점,12,12,0,100.0,0.0
박가부대 성수코오롱디지털밸리점,12,12,0,100.0,0.0
베러로스팅랩&쇼룸,12,11,1,91.7,8.3
웨이크앤베이크 성수,12,12,0,100.0,0.0
윌리스엘에이피자,12,12,0,100.0,0.0
성수물고기,11,11,0,100.0,0.0
써니,11,11,0,100.0,0.0
케이지드,11,11,0,100.0,0.0
맛보래,11,11,0,100.0,0.0
포메인 서울숲점,11,11,0,100.0,0.0
우리동네칼국수,11,10,1,90.9,9.1
DYI WORKSHOP,11,11,0,100.0,0.0
서울숲 포도피자,11,11,0,100.0,0.0
술있는식탁,11,11,0,100.0,0.0
엘몰리노,11,10,1,90.9,9.1
플러드,11,11,0,100.0,0.0
햄찌와베찌 뚝섬점,11,11,0,100.0,0.0
희정보감족,11,11,0,100.0,0.0
성수골목,11,10,1,90.9,9.1
포지티브 제로 라운지,11,10,1,90.9,9.1
광장족발 본가,11,11,0,100.0,0.0
노랑통닭 성수점,11,11,0,100.0,0.0
브로벨커피,11,11,0,100.0,0.0
쿠시범,11,10,1,90.9,9.1
베르두레 성수점,11,11,0,100.0,0.0
담소소사골순대육개장 성수시그마밸리점,11,11,0,100.0,0.0
피읻짜,11,11,0,100.0,0.0
참나무로 바베큐,11,10,1,90.9,9.1
원산면옥,11,10,1,90.9,9.1
전통씨래기국밥,11,10,1,90.9,9.1
엉터리생고기 성수점,11,11,0,100.0,0.0
파스쿠찌 서울숲점,11,10,1,90.9,9.1
뱅글,11,11,0,100.0,0.0
뚝섬숯불갈비,11,10,1,90.9,9.1
성수오오,11,11,0,100.0,0.0
다미,11,10,1,90.9,9.1
두루치기김치찌개,11,11,0,100.0,0.0
성수장,11,11,0,100.0,0.0
대포차,11,11,0,100.0,0.0
순심이네생삼겹,11,11,0,100.0,0.0
라성천사,11,11,0,100.0,0.0
동강,11,11,0,100.0,0.0
우디집,11,10,1,90.9,9.1
커피기업 서울숲점,10,10,0,100.0,0.0
동촌샤브칼국수,10,9,1,90.0,10.0
이트앤드링크,10,10,0,100.0,0.0
역삼칼국수,10,9,1,90.0,10.0
미크컴퍼니,10,10,0,100.0,0.0
웰컴차이나,10,10,0,100.0,0.0
오프커피,10,10,0,100.0,0.0
땡초꼼장어,10,10,0,100.0,0.0
위풍당당족발,10,8,2,80.0,20.0
숲속식사 철판볶음밥,10,10,0,100.0,0.0
대돈집,10,10,0,100.0,0.0
밥플러스 아이티캐슬점,10,8,2,80.0,20.0
현대옥 서울숲점,10,10,0,100.0,0.0
밀단지,10,10,0,100.0,0.0
성수초밥 성수점,10,9,1,90.0,10.0
성수식당,10,10,0,100.0,0.0
카페 스트랏,10,10,0,100.0,0.0
열기,10,10,0,100.0,0.0
호랑도,10,9,1,90.0,10.0
신신원,10,10,0,100.0,0.0
EZER Coffee,10,10,0,100.0,0.0
뚝섬김밥,10,10,0,100.0,0.0
또치 참숯생고기,10,10,0,100.0,0.0
오씨네 덮밥,10,9,1,90.0,10.0
셀렉토커피 서울숲IT캐슬점,10,10,0,100.0,0.0
위키드와이프,10,10,0,100.0,0.0
잭슨피자 성수점,10,10,0,100.0,0.0
코스모스상점,9,8,1,88.9,11.1
호감도,9,8,1,88.9,11.1
병천순대국 성수점,9,9,0,100.0,0.0
소안도풍경,9,7,2,77.8,22.2
춘천닭갈비,9,8,1,88.9,11.1
카페 스밍 스튜디오,9,8,1,88.9,11.1
세븐갈비,9,8,1,88.9,11.1
땡기면땡비어,9,9,0,100.0,0.0
카페랏102,9,9,0,100.0,0.0
시치미,9,8,1,88.9,11.1
걸작떡볶이치킨 성수점,9,9,0,100.0,0.0
카페크라비,9,9,0,100.0,0.0
성수일구,9,9,0,100.0,0.0
맛닭꼬 뚝섬점,9,9,0,100.0,0.0
찐짜솥뚜껑삼겹살갈비,9,9,0,100.0,0.0
김가네김밥 성수시그마밸리점,9,9,0,100.0,0.0
반가백암순대,9,9,0,100.0,0.0
309디저트카페,9,9,0,100.0,0.0
천미향,9,8,1,88.9,11.1
가마솥추어탕,9,9,0,100.0,0.0
쉐프우,9,8,1,88.9,11.1
생활맥주 성수 한라시그마밸리점,9,9,0,100.0,0.0
옛골감자탕,9,9,0,100.0,0.0
장맛손칼국수,9,8,1,88.9,11.1
개성상인,9,8,1,88.9,11.1
아웃오브타임,9,9,0,100.0,0.0
텐바,9,9,0,100.0,0.0
피자스쿨 뚝섬역점,9,9,0,100.0,0.0
청죽골 2호점,9,9,0,100.0,0.0
쓰리오브어스,9,8,1,88.9,11.1
커피스미스,9,9,0,100.0,0.0
명가닭한마리,9,8,1,88.9,11.1
스탠드업플리즈바이턴온,9,9,0,100.0,0.0
왕분식,9,9,0,100.0,0.0
토끼와거북전,9,9,0,100.0,0.0
얼룩,9,9,0,100.0,0.0
행운한식뷔페,8,8,0,100.0,0.0
피자알볼로 성수점,8,8,0,100.0,0.0
홍정원,8,7,1,87.5,12.5
브레드온,8,8,0,100.0,0.0
굴국밥현이네,8,8,0,100.0,0.0
진짜배기명태촌 서울성수점,8,8,0,100.0,0.0
도미노피자 서울숲점,8,8,0,100.0,0.0
프레이커피바 PCB서울,8,8,0,100.0,0.0
파인와플,8,8,0,100.0,0.0
갈랭,8,8,0,100.0,0.0
앙심품은도야지,8,8,0,100.0,0.0
온슬,8,7,1,87.5,12.5
성수불타는곱창,8,8,0,100.0,0.0
경성찹쌀꽈배기 뚝섬점,8,8,0,100.0,0.0
성수칼국수,8,6,2,75.0,25.0
요고프로즌요거트 서울숲점,8,8,0,100.0,0.0
호타루,8,8,0,100.0,0.0
조양생고기순대국,8,8,0,100.0,0.0
홍천숯닭,8,8,0,100.0,0.0
밥플러스 에이스하이엔드점,8,8,0,100.0,0.0
노을 2관,8,8,0,100.0,0.0
호랑이식탁,8,8,0,100.0,0.0
성수닭발,8,8,0,100.0,0.0
최가네 국수 김밥,8,8,0,100.0,0.0
이야기가있는밥집,8,8,0,100.0,0.0
밀카페 우프,8,7,1,87.5,12.5
어커,8,8,0,100.0,0.0
포보스,8,7,1,87.5,12.5
모어,8,8,0,100.0,0.0
어글리크림치즈,8,7,1,87.5,12.5
코사이어티 서울숲,8,8,0,100.0,0.0
와규오감,8,8,0,100.0,0.0
FINZ 핀즈,8,8,0,100.0,0.0
동맛골보쌈칼국수,8,8,0,100.0,0.0
마누,8,8,0,100.0,0.0
일미돼지국밥,8,7,1,87.5,12.5
룰루랄라 뚝섬역점,8,7,1,87.5,12.5
진지방순대국,8,8,0,100.0,0.0
다모아뷔페,8,7,1,87.5,12.5
성수꼬마,8,8,0,100.0,0.0
해밀칼국수 성수점,8,8,0,100.0,0.0
성수망치버거,8,8,0,100.0,0.0
황금어장,8,8,0,100.0,0.0
서울숲오삼불고기,8,8,0,100.0,0.0
일월수제만두,8,8,0,100.0,0.0
글리터,7,7,0,100.0,0.0
밀향기,7,7,0,100.0,0.0
성수리얼,7,6,1,85.7,14.3
서후와규,7,7,0,100.0,0.0
짬뽕타운,7,7,0,100.0,0.0
레이어10 카페,7,7,0,100.0,0.0
성수 팍스부대찌개 본점,7,7,0,100.0,0.0
사흘카레,7,7,0,100.0,0.0
KROW,7,7,0,100.0,0.0
물레방아민물매운탕,7,7,0,100.0,0.0
릴레이션 카페,7,6,1,85.7,14.3
코코호도 성수점,7,7,0,100.0,0.0
후다닭Q 본점,7,7,0,100.0,0.0
플래닝샐러드,7,7,0,100.0,0.0
씨씨씨,7,7,0,100.0,0.0
까사다루아,7,7,0,100.0,0.0
KANTO 성수,7,6,1,85.7,14.3
피자헛 성수점,7,7,0,100.0,0.0
서울숲백반,7,7,0,100.0,0.0
이안식당,7,7,0,100.0,0.0
플로이 FLOWY,7,7,0,100.0,0.0
후프커피,7,6,1,85.7,14.3
송가,7,6,1,85.7,14.3
이흥부오향족발 뚝섬점,7,7,0,100.0,0.0
성수손칼국수,7,6,1,85.7,14.3
퍼멘티드 고스트,7,7,0,100.0,0.0
뜸들이다 성수점,7,7,0,100.0,0.0
유향소,7,7,0,100.0,0.0
소소한가게,7,7,0,100.0,0.0
카페오라,7,7,0,100.0,0.0
맛닭꼬 성수뚝도점,7,6,1,85.7,14.3
더키더키,7,6,1,85.7,14.3
구시월닭한마리,7,6,1,85.7,14.3
김밥천국 서울숲점,7,7,0,100.0,0.0
도믹스,7,7,0,100.0,0.0
온에떼라,7,7,0,100.0,0.0
스시포레,7,7,0,100.0,0.0
CAFE FLARES,7,7,0,100.0,0.0
오키초밥,7,7,0,100.0,0.0
세이버앤페이버,7,7,0,100.0,0.0
bakery tomo,7,6,1,85.7,14.3
스시도쿠 더성수,7,7,0,100.0,0.0
큰맘할매순대국 성수동점,7,7,0,100.0,0.0
에이치커피로스터스,7,7,0,100.0,0.0
고흥만,7,7,0,100.0,0.0
하남돼지집 성수역점,7,6,1,85.7,14.3
쁘띠그랑,7,7,0,100.0,0.0
풍년숯불돼지갈비,7,7,0,100.0,0.0
파라디,7,7,0,100.0,0.0
BBQ치킨 성수2점,7,7,0,100.0,0.0
인덱스카라멜,7,7,0,100.0,0.0
빙맥홀닭 서울숲점,6,6,0,100.0,0.0
목로정원,6,5,1,83.3,16.7
삼천만활어횟집,6,6,0,100.0,0.0
뚝섬생고기,6,5,1,83.3,16.7
렌게,6,6,0,100.0,0.0
모므로살롱,6,6,0,100.0,0.0
더리터 성수역점,6,5,1,83.3,16.7
엘이펀,6,6,0,100.0,0.0
pvglab,6,6,0,100.0,0.0
도토리편백집 이마트성수점,6,6,0,100.0,0.0
청주한씨,6,6,0,100.0,0.0
정참치,6,6,0,100.0,0.0
하루나,6,5,1,83.3,16.7
미각짬뽕양꼬치,6,6,0,100.0,0.0
그린랩,6,6,0,100.0,0.0
송계옥성수점,6,4,2,66.7,33.3
맛차차,6,6,0,100.0,0.0
댓길,6,5,1,83.3,16.7
라스베이글 성수점,6,6,0,100.0,0.0
명동할머니국수 성수카페거리점,6,6,0,100.0,0.0
서래,6,6,0,100.0,0.0
콜렉트,6,6,0,100.0,0.0
부뚜막,6,6,0,100.0,0.0
카페조이,6,6,0,100.0,0.0
한끼,6,6,0,100.0,0.0
제주뒷고기,6,6,0,100.0,0.0
행닭바베큐통닭,6,6,0,100.0,0.0
밤새우리,6,6,0,100.0,0.0
리커버리커피바,6,6,0,100.0,0.0
소바짐,6,5,1,83.3,16.7
프라이데이무브먼트,6,6,0,100.0,0.0
레타주,6,6,0,100.0,0.0
장흥식당,6,6,0,100.0,0.0
연탄요릿집,6,6,0,100.0,0.0
시골집,6,6,0,100.0,0.0
송범순대국,6,5,1,83.3,16.7
이삭토스트 성수2가점,6,6,0,100.0,0.0
또와,6,6,0,100.0,0.0
수칼국수,6,6,0,100.0,0.0
그라데이션커피,6,6,0,100.0,0.0
라무진 성수카페거리점,6,6,0,100.0,0.0
예셰숄,6,6,0,100.0,0.0
모이크,6,6,0,100.0,0.0
복닭 성수점,6,6,0,100.0,0.0
송강제면소,6,6,0,100.0,0.0
에그마카슈 성수,6,6,0,100.0,0.0
송담추어탕 서울성수점,6,6,0,100.0,0.0
그룬트,6,6,0,100.0,0.0
피에스비 커피바,6,6,0,100.0,0.0
플라이팬커피 뚝섬점,6,6,0,100.0,0.0
커피베이 성동성수점,6,5,1,83.3,16.7
바위파스타바 성수,6,6,0,100.0,0.0
가내수공업고깃집,6,5,1,83.3,16.7
박가객주,6,6,0,100.0,0.0
삼미냉면칼국수,6,6,0,100.0,0.0
행운호프,6,6,0,100.0,0.0
뚝시돈,5,5,0,100.0,0.0
회현집,5,5,0,100.0,0.0
메쉬커피,5,4,1,80.0,20.0
피터팬돈까스,5,5,0,100.0,0.0
제로드,5,5,0,100.0,0.0
글리머,5,5,0,100.0,0.0
구스케이지,5,5,0,100.0,0.0
생삼겹장수유황오리,5,5,0,100.0,0.0
서울앵무새,5,5,0,100.0,0.0
제스티살룬성수,5,5,0,100.0,0.0
알파카페,5,5,0,100.0,0.0
햄서울,5,5,0,100.0,0.0
지코바치킨 성수1호점,5,5,0,100.0,0.0
토프레소 성수우림점,5,4,1,80.0,20.0
깡통집,5,5,0,100.0,0.0
다담,5,5,0,100.0,0.0
닷성수,5,5,0,100.0,0.0
음악창고 LP BAR,5,5,0,100.0,0.0
오시요거트,5,5,0,100.0,0.0
노우노우바운즈,5,5,0,100.0,0.0
하피,5,5,0,100.0,0.0
Kompakt Record Bar ver3,5,3,2,60.0,40.0
자매집생선구이,5,5,0,100.0,0.0
커피식탁,5,5,0,100.0,0.0
힘냉면록,5,5,0,100.0,0.0
티핀,5,5,0,100.0,0.0
스시모리,5,5,0,100.0,0.0
신명먹거리,5,5,0,100.0,0.0
승리원,5,5,0,100.0,0.0
황기닭한마리,5,5,0,100.0,0.0
Cafe B&S,5,5,0,100.0,0.0
둘둘치킨 성수1호점,5,5,0,100.0,0.0
땅스부대찌개 성수점,5,5,0,100.0,0.0
전주집,5,5,0,100.0,0.0
색다른면,5,5,0,100.0,0.0
아구보구,5,5,0,100.0,0.0
레드브릭스모크하우스,5,5,0,100.0,0.0
이탈리안 누들,5,4,1,80.0,20.0
참참치킨 성수점,5,5,0,100.0,0.0
밥플러스 6호점,5,5,0,100.0,0.0
제이엠,5,4,1,80.0,20.0
우영푸드빌,5,5,0,100.0,0.0
풍년식당,5,4,1,80.0,20.0
우리집밥,5,5,0,100.0,0.0
본도시락 성수점,5,5,0,100.0,0.0
맛부,5,5,0,100.0,0.0
뚝도지기,5,5,0,100.0,0.0
윤돈,5,5,0,100.0,0.0
문화공간 성수,5,5,0,100.0,0.0
코너룸,5,5,0,100.0,0.0
페이지스,5,5,0,100.0,0.0
헤이피자,5,5,0,100.0,0.0
아이아이알,5,5,0,100.0,0.0
푸라닭 성수2가점,5,5,0,100.0,0.0
원샷치킨,5,4,1,80.0,20.0
성수동양갈비,5,5,0,100.0,0.0
성운,5,5,0,100.0,0.0
전통숯불꼼장어,5,5,0,100.0,0.0
성수낙지,5,5,0,100.0,0.0
커피코코,5,5,0,100.0,0.0
스시라온,5,5,0,100.0,0.0
파파존스 성수점,4,4,0,100.0,0.0
카페바로,4,3,1,75.0,25.0
LAZZO,4,4,0,100.0,0.0
성수숯불갈비,4,4,0,100.0,0.0
온누리식당,4,4,0,100.0,0.0
해피캔디쿠키,4,4,0,100.0,0.0
돼지맘,4,4,0,100.0,0.0
와인바킥,4,3,1,75.0,25.0
성수뚝배기,4,4,0,100.0,0.0
남경관,4,4,0,100.0,0.0
아뜰리에 드 라 크레페,4,4,0,100.0,0.0
영화104,4,4,0,100.0,0.0
시골가마솥삼겹살 성수점,4,3,1,75.0,25.0
BBQ치킨 성수3점,4,3,1,75.0,25.0
진수성찬한식뷔페,4,4,0,100.0,0.0
그린웰빙한식부페,4,4,0,100.0,0.0
스모크키친서울,4,4,0,100.0,0.0
용짜장,4,4,0,100.0,0.0
per week,4,4,0,100.0,0.0
유메이규,4,4,0,100.0,0.0
뺌치킨,4,4,0,100.0,0.0
한세희복집,4,4,0,100.0,0.0
혜성분식,4,4,0,100.0,0.0
소나무커피,4,4,0,100.0,0.0
나나횟집,4,4,0,100.0,0.0
김종욱 커피,4,4,0,100.0,0.0
조리,4,4,0,100.0,0.0
피카워크샵,4,4,0,100.0,0.0
어촌횟집,4,4,0,100.0,0.0
화양리우동집,4,4,0,100.0,0.0
신의주순대와쭈꾸미 성수점,4,4,0,100.0,0.0
디스코커피,4,4,0,100.0,0.0
연탄구이집,4,4,0,100.0,0.0
호식이두마리치킨 서울숲점,4,4,0,100.0,0.0
태양각,4,4,0,100.0,0.0
모멘토브루어스,4,3,1,75.0,25.0
부덕관,4,4,0,100.0,0.0
춘천닭갈비낙지철판,4,4,0,100.0,0.0
카페수다,4,4,0,100.0,0.0
찐미 숯불구이,4,4,0,100.0,0.0
케슬리 본점,4,4,0,100.0,0.0
더존푸드,4,4,0,100.0,0.0
장수숯불갈비,4,4,0,100.0,0.0
너랑나랑 콩나물국밥삼겹살,4,4,0,100.0,0.0
프랑스포차,4,4,0,100.0,0.0
장안식당,4,4,0,100.0,0.0
민티베리,4,4,0,100.0,0.0
넌 꼬막 난 육회,4,4,0,100.0,0.0
모호인,4,4,0,100.0,0.0
크레송,4,4,0,100.0,0.0
돼지네생삼겹살,4,4,0,100.0,0.0
멜로워,4,3,1,75.0,25.0
카페온화 본사,4,4,0,100.0,0.0
기왕생고기,4,4,0,100.0,0.0
빨간마초닭발 성수점,4,4,0,100.0,0.0
최가네부대찌개,4,4,0,100.0,0.0
영구스피자 성수점,4,4,0,100.0,0.0
코끼리베이글성수,4,4,0,100.0,0.0
마를리,4,4,0,100.0,0.0
솔솥성수점,4,4,0,100.0,0.0
네네치킨 성수2가점,4,4,0,100.0,0.0
하이엔드라이,4,4,0,100.0,0.0
둘둘치킨 뚝섬점,4,4,0,100.0,0.0
YENA,4,4,0,100.0,0.0
더다미,3,2,1,66.7,33.3
모어딥 성수,3,3,0,100.0,0.0
성수족발,3,2,1,66.7,33.3
미정이네식당,3,3,0,100.0,0.0
차만다서울숲점,3,3,0,100.0,0.0
성수스타우트,3,3,0,100.0,0.0
카페라니,3,3,0,100.0,0.0
성수동골룸 서울숲 해산물 포장마차,3,3,0,100.0,0.0
뚝섬삼겹,3,3,0,100.0,0.0
메모레,3,3,0,100.0,0.0
흙과나무,3,3,0,100.0,0.0
2002횟집,3,1,2,33.3,66.7
청수먹거리,3,3,0,100.0,0.0
김사부코다리,3,3,0,100.0,0.0
태풍순대국,3,3,0,100.0,0.0
카페 마렐,3,2,1,66.7,33.3
중앙가속기,3,3,0,100.0,0.0
100회,3,2,1,66.7,33.3
달님이네,3,3,0,100.0,0.0
조이푸드,3,3,0,100.0,0.0
용싸롱,3,3,0,100.0,0.0
논스톱샌드위치,3,3,0,100.0,0.0
내추럴,3,3,0,100.0,0.0
중국관,3,3,0,100.0,0.0
오스테리아 로에로,3,3,0,100.0,0.0
뵈르니,3,3,0,100.0,0.0
착한족발 성수점,3,3,0,100.0,0.0
LOWIDE,3,3,0,100.0,0.0
딤플맥주양주,3,3,0,100.0,0.0
엘라,3,3,0,100.0,0.0
또래오래 성수점,3,2,1,66.7,33.3
제주올레포차 2호점,3,3,0,100.0,0.0
먹을만회,3,3,0,100.0,0.0
일루오리,3,3,0,100.0,0.0
Make,3,3,0,100.0,0.0
알천 성동본점,3,3,0,100.0,0.0
봉짬뽕,3,3,0,100.0,0.0
nothingmatters,3,3,0,100.0,0.0
참숯나라갈비마을,3,3,0,100.0,0.0
본,3,3,0,100.0,0.0
카페 차 성수점,3,3,0,100.0,0.0
글레이셔박,3,3,0,100.0,0.0
오일장,3,3,0,100.0,0.0
옴시롱 감시롱 순대국,3,3,0,100.0,0.0
남원콩나물국밥,3,3,0,100.0,0.0
싱싱횟집,3,3,0,100.0,0.0
바탕,3,3,0,100.0,0.0
두남자의개수작,3,3,0,100.0,0.0
새촌식탁,3,3,0,100.0,0.0
BHC치킨 성수역점,3,3,0,100.0,0.0
빌로위 성수,3,3,0,100.0,0.0
작야,3,3,0,100.0,0.0
베트남쌀국수,3,3,0,100.0,0.0
앵무새루이스,3,3,0,100.0,0.0
압구정샌드위치 성수점,3,3,0,100.0,0.0
국일돼지왕갈비생삼겹살,3,2,1,66.7,33.3
이지더즈잇,3,3,0,100.0,0.0
키보우 라멘,3,3,0,100.0,0.0
퀴바라,3,3,0,100.0,0.0
큐리크,3,3,0,100.0,0.0
잔치국수아줌마,3,3,0,100.0,0.0
미사랑,3,3,0,100.0,0.0
더킹돈 뚝섬점,3,2,1,66.7,33.3
교촌치킨 성수1호점,3,3,0,100.0,0.0
양평서울해장국큰아들집 성동세무서점,3,3,0,100.0,0.0
코시나,3,2,1,66.7,33.3
카페아모렘,3,3,0,100.0,0.0
백이의,3,3,0,100.0,0.0
정든집,3,3,0,100.0,0.0
담바골,3,3,0,100.0,0.0
하노이바게트,3,3,0,100.0,0.0
미정이네코다리찜,3,3,0,100.0,0.0
레드이즈미,3,3,0,100.0,0.0
55주막,3,3,0,100.0,0.0
강남빈대떡,3,3,0,100.0,0.0
성수다락,2,2,0,100.0,0.0
할아버지공장,2,1,1,50.0,50.0
현영이네,2,1,1,50.0,50.0
페를 perle,2,2,0,100.0,0.0
동호마을명태코다리,2,2,0,100.0,0.0
우리네밥상,2,2,0,100.0,0.0
온량,2,2,0,100.0,0.0
꽈배기에 반한 치킨 성수점,2,2,0,100.0,0.0
죽고을,2,2,0,100.0,0.0
밀도,2,2,0,100.0,0.0
포크앤라이프,2,2,0,100.0,0.0
호호식당,2,2,0,100.0,0.0
칠성옻닭,2,2,0,100.0,0.0
오니기리와이규동 성수점,2,1,1,50.0,50.0
93밀리언마일즈,2,2,0,100.0,0.0
세스크멘슬,2,2,0,100.0,0.0
카페 메이,2,2,0,100.0,0.0
꼬꼬누리 성수이마트점,2,2,0,100.0,0.0
로우커피스탠드 성수점,2,2,0,100.0,0.0
테이블 소사이어티 클럽,2,2,0,100.0,0.0
커피덕후,2,2,0,100.0,0.0
행복한집,2,2,0,100.0,0.0
센터커피,2,2,0,100.0,0.0
쵸리상경,2,2,0,100.0,0.0
커피베이 서울숲AK밸리점,2,2,0,100.0,0.0
독도참치 성수점,2,2,0,100.0,0.0
살롱드가벵양,2,2,0,100.0,0.0
성수부엌,2,2,0,100.0,0.0
백야드빌더성수,2,1,1,50.0,50.0
에이그레이트카페 성수점,2,2,0,100.0,0.0
부경,2,2,0,100.0,0.0
소소하게,2,2,0,100.0,0.0
화랑직화구이,2,2,0,100.0,0.0
우동가조쿠 성수점,2,2,0,100.0,0.0
컴포즈커피 성수역점,2,2,0,100.0,0.0
5to7,2,2,0,100.0,0.0
어니언성수점,2,2,0,100.0,0.0
리브나 Rivna,2,2,0,100.0,0.0
성수기,2,2,0,100.0,0.0
천수곱창,2,2,0,100.0,0.0
과일파는 덕이언니,2,2,0,100.0,0.0
더블핸스테이크 서울숲점,2,2,0,100.0,0.0
블루보틀성수점,2,2,0,100.0,0.0
삼원,2,2,0,100.0,0.0
조선커피 성수점,2,2,0,100.0,0.0
유진참치,2,2,0,100.0,0.0
등심집,2,2,0,100.0,0.0
용이네 뚝섬역점,2,1,1,50.0,50.0
진국해장국,2,2,0,100.0,0.0
모루타루,2,2,0,100.0,0.0
백리향중화요리,2,2,0,100.0,0.0
영식품,2,2,0,100.0,0.0
신촌설렁탕,2,2,0,100.0,0.0
라성키친,2,2,0,100.0,0.0
시장설렁탕,2,2,0,100.0,0.0
푸른바다횟집,2,2,0,100.0,0.0
서울에스프레소,2,2,0,100.0,0.0
오비광장,2,1,1,50.0,50.0
대성정,2,2,0,100.0,0.0
대흥정육식당,2,2,0,100.0,0.0
꾸이한끼 성수점,2,2,0,100.0,0.0
원조장충왕족발,2,2,0,100.0,0.0
카페온유,2,2,0,100.0,0.0
파치비 성수점,2,2,0,100.0,0.0
플록스,2,2,0,100.0,0.0
소문난생만두 성수역점,2,0,2,0.0,100.0
에바스,2,2,0,100.0,0.0
옛날순대국밥,2,2,0,100.0,0.0
형제갈비,2,2,0,100.0,0.0
타임애프터타임,2,2,0,100.0,0.0
사길이삼,2,2,0,100.0,0.0
성수동꽈배기 로고스타,2,2,0,100.0,0.0
큐씨오,2,2,0,100.0,0.0
어썸브로시스,2,2,0,100.0,0.0
리퀴드랩,2,2,0,100.0,0.0
5스타커피 셀렉트샵 서울숲점,2,2,0,100.0,0.0
amado,2,2,0,100.0,0.0
삼삼이네생고기 성수점,2,2,0,100.0,0.0
썬카페,2,2,0,100.0,0.0
비어호프,2,0,2,0.0,100.0
영동식당,2,2,0,100.0,0.0
오프비트,2,2,0,100.0,0.0
투달러스커피,2,1,1,50.0,50.0
배떡 성수점,2,2,0,100.0,0.0
풍년정육점식당,2,2,0,100.0,0.0
파주부대찌개,2,2,0,100.0,0.0
스몰글라스,2,2,0,100.0,0.0
쿠켄치킨호프 성수점,2,2,0,100.0,0.0
뚝도리보신탕,2,2,0,100.0,0.0
한낮의밤,2,2,0,100.0,0.0
어페어커피,2,2,0,100.0,0.0
완산골콩나물국밥,1,1,0,100.0,0.0
조프리케이크,1,1,0,100.0,0.0
라일락,1,1,0,100.0,0.0
성수 곰식당 2층,1,1,0,100.0,0.0
문화식당,1,1,0,100.0,0.0
뚝도국수집,1,1,0,100.0,0.0
오카보카,1,1,0,100.0,0.0
베러초이스,1,1,0,100.0,0.0
비사벌전주콩나물국밥,1,1,0,100.0,0.0
일정,1,1,0,100.0,0.0
시골옻닭,1,1,0,100.0,0.0
난포,1,1,0,100.0,0.0
야곱293,1,1,0,100.0,0.0
원조감자탕,1,1,0,100.0,0.0
태백집 성수점,1,1,0,100.0,0.0
DODODO,1,1,0,100.0,0.0
메이플탑,1,1,0,100.0,0.0
황소미가,1,1,0,100.0,0.0
성수베이킹스튜디오,1,1,0,100.0,0.0
행복식당,1,1,0,100.0,0.0
먼치스앤구디스,1,1,0,100.0,0.0
소랑호젠,1,1,0,100.0,0.0
동신식당,1,1,0,100.0,0.0
라운지카니보,1,1,0,100.0,0.0
얼큰이왕냉면,1,1,0,100.0,0.0
윕성수,1,1,0,100.0,0.0
전주식당,1,1,0,100.0,0.0
우오보파스타바,1,1,0,100.0,0.0
꾸아,1,1,0,100.0,0.0
영계소문 옛날통닭,1,1,0,100.0,0.0
광순네식당,1,1,0,100.0,0.0
숙영이네,1,1,0,100.0,0.0
병천순대국,1,1,0,100.0,0.0
마스,1,1,0,100.0,0.0
심토불이,1,1,0,100.0,0.0
십삼동,1,1,0,100.0,0.0
Naked Coffee,1,1,0,100.0,0.0
도슨트 성수,1,1,0,100.0,0.0
윤식당 한식뷔페,1,1,0,100.0,0.0
성연순대국&족발,1,1,0,100.0,0.0
제일,1,1,0,100.0,0.0
넘버파이브,1,1,0,100.0,0.0
멜드샌드위치,1,1,0,100.0,0.0
피자파는집 서울성수점,1,1,0,100.0,0.0
맥문동호프,1,1,0,100.0,0.0
더퍼즈,1,1,0,100.0,0.0
까칠이,1,1,0,100.0,0.0
JAFA Brewery,1,1,0,100.0,0.0
자금성,1,1,0,100.0,0.0
별미식당,1,1,0,100.0,0.0
뽀식이네부페식당,1,1,0,100.0,0.0
뿐또블루,1,1,0,100.0,0.0
번번,1,1,0,100.0,0.0
어랑횟집,1,1,0,100.0,0.0
씨에이크,1,1,0,100.0,0.0
생태한마리,1,1,0,100.0,0.0
셀럽드샐러드,1,1,0,100.0,0.0
그레이박스,1,1,0,100.0,0.0
한성식당,1,1,0,100.0,0.0
백억포차,1,1,0,100.0,0.0
앙골로에스프레소,1,1,0,100.0,0.0
서산식당,1,1,0,100.0,0.0
우림식당,1,1,0,100.0,0.0
민물집,1,1,0,100.0,0.0
골목집,1,1,0,100.0,0.0
탕가네,1,1,0,100.0,0.0
세컨드파이브,1,1,0,100.0,0.0
야끼도리정,1,1,0,100.0,0.0
독보,1,1,0,100.0,0.0
알디파트너스투자1호,1,1,0,100.0,0.0
루덴스파트너스,1,1,0,100.0,0.0
충남식당,1,1,0,100.0,0.0
쥬씨 성수IT점,1,1,0,100.0,0.0
양과자점 라보엠,1,1,0,100.0,0.0
부성식당,1,1,0,100.0,0.0
포피나 라운지,1,1,0,100.0,0.0
이오커피로스터스,1,1,0,100.0,0.0
카페일로,1,1,0,100.0,0.0
88켄터키 성수점,1,1,0,100.0,0.0
내고향정육점식당,1,1,0,100.0,0.0
종가빈대떡,1,1,0,100.0,0.0
훈이네,1,1,0,100.0,0.0
삼청당 성수점,1,1,0,100.0,0.0
오가네밥상,1,1,0,100.0,0.0
낙타커피로스터스,1,1,0,100.0,0.0
장위동유성집 성동점,1,1,0,100.0,0.0
소적두 성수점,1,1,0,100.0,0.0
오가네숯불곰장어,1,1,0,100.0,0.0
호남식당,1,1,0,100.0,0.0
오드비,1,1,0,100.0,0.0
글램 바,1,1,0,100.0,0.0
한남양옥 성수,1,0,1,0.0,100.0
투다리 뚝섬점,1,0,1,0.0,100.0
잇쇼우,1,1,0,100.0,0.0
