호텔,리뷰 개수,긍정 리뷰 개수,부정 리뷰 개수,긍정 리뷰 비율,부정 리뷰 비율
커피크레페본점,421,418,3,99.3,0.7
백소정 신촌점,417,416,1,99.8,0.2
룸의정석 신촌점,300,296,4,98.7,1.3
대끼리 돈까스,220,220,0,100.0,0.0
천궁전마라탕,200,200,0,100.0,0.0
카린지린가네스낵바 신촌점,197,193,4,98.0,2.0
오늘와인한잔 신촌역점,189,189,0,100.0,0.0
탈리,189,185,4,97.9,2.1
오므파탈 신촌점,182,182,0,100.0,0.0
호탕마라탕,175,175,0,100.0,0.0
마더린러 베이글,123,122,1,99.2,0.8
독립문설렁탕,110,107,3,97.3,2.7
형제갈비,110,106,4,96.4,3.6
메가MGC커피 신촌로터리점,102,102,0,100.0,0.0
잠바주스 연세세브란스점,100,95,5,95.0,5.0
브릭스5221맥주 신촌점,97,96,1,99.0,1.0
기꾸스시,96,88,8,91.7,8.3
파리바게뜨 카페이대역점,96,90,6,93.8,6.2
청춘대로,93,92,1,98.9,1.1
보승회관 서울신촌점,92,87,5,94.6,5.4
명륜진사갈비 서울신촌점,88,88,0,100.0,0.0
머노까머나 신촌점,88,88,0,100.0,0.0
지니네컵밥,88,88,0,100.0,0.0
롯데리아 이대점,86,85,1,98.8,1.2
역전우동0410 신촌점,86,83,3,96.5,3.5
플라페,84,83,1,98.8,1.2
티앙팡 오후의 홍차,82,82,0,100.0,0.0
고르드,81,79,2,97.5,2.5
영미김밥,81,79,2,97.5,2.5
맘스터치 이대점,81,78,3,96.3,3.7
돈까스대왕전 이대점,78,78,0,100.0,0.0
타코벨 신촌점,78,76,2,97.4,2.6
백년당 마라탕 본점,77,76,1,98.7,1.3
투썸플레이스 이대역점,76,71,5,93.4,6.6
이디야커피 신촌역점,76,73,3,96.1,3.9
미스타교자 신촌,74,73,1,98.6,1.4
싸다김밥 신촌점,74,72,2,97.3,2.7
리버트리커피,73,73,0,100.0,0.0
오늘통닭 신촌직영점,72,71,1,98.6,1.4
이삭토스트 서울신촌점,72,72,0,100.0,0.0
옥희네 떡볶이,70,69,1,98.6,1.4
삭 수제튀김 전문점,69,65,4,94.2,5.8
엠브로돈까스 신촌본점,67,65,2,97.0,3.0
피슈마라홍탕 신촌점,66,66,0,100.0,0.0
메가MGC커피 창천점,65,60,5,92.3,7.7
대성이네,65,65,0,100.0,0.0
대파곱창,65,63,2,96.9,3.1
포베이 연세암병원점,64,63,1,98.4,1.6
사장님돈까스 이화여대점,64,63,1,98.4,1.6
헤이진,64,64,0,100.0,0.0
리히트,64,64,0,100.0,0.0
타오마라탕 신촌점,64,64,0,100.0,0.0
롤링파스타 신촌점,62,58,4,93.5,6.5
김진환 제과점,61,61,0,100.0,0.0
빽다방 신촌역점,60,59,1,98.3,1.7
돈우마미,60,60,0,100.0,0.0
팔공티 신촌점,60,58,2,96.7,3.3
부탄츄 신촌점,59,56,3,94.9,5.1
연희김밥 신촌점,57,57,0,100.0,0.0
구씨네부엌,57,57,0,100.0,0.0
또보겠지떡볶이집 신촌히어로점,56,55,1,98.2,1.8
소바연구소,55,52,3,94.5,5.5
금고기비스트로 신촌,53,51,2,96.2,3.8
고향전주비빔밥 현대백화점신촌점,53,51,2,96.2,3.8
마녀주방 신촌점,53,49,4,92.5,7.5
맘맘테이블,52,52,0,100.0,0.0
김광석신촌칼국수 본점,52,48,4,92.3,7.7
춘천집닭갈비본사직영철판구이,52,51,1,98.1,1.9
본죽 세브란스병원점,51,47,4,92.2,7.8
방콕익스프레스 신촌본점,50,49,1,98.0,2.0
닥터로빈 이대점,50,50,0,100.0,0.0
소신이쏘 신촌본점,50,47,3,94.0,6.0
클로리스 신촌본점,49,47,2,95.9,4.1
김삼보김치찌개 신촌점,49,49,0,100.0,0.0
씨유그릭,49,48,1,98.0,2.0
독수리다방,48,46,2,95.8,4.2
호루몬 우직,48,48,0,100.0,0.0
버거리 신촌점,47,47,0,100.0,0.0
비아37,46,45,1,97.8,2.2
레이지리자드,46,46,0,100.0,0.0
라구식당,45,45,0,100.0,0.0
인타코타코야끼&캔카페,45,45,0,100.0,0.0
던킨 연대동문회관점,44,43,1,97.7,2.3
팔공티 이대점,44,43,1,97.7,2.3
포티드,43,41,2,95.3,4.7
연세로갈매기,43,43,0,100.0,0.0
카페나무,43,41,2,95.3,4.7
야곱의축복 신촌점,43,43,0,100.0,0.0
복성각,42,41,1,97.6,2.4
춘천집 닭갈비막국수,42,42,0,100.0,0.0
맛있는순두부&김치찜,42,37,5,88.1,11.9
강남불백 신촌점,42,41,1,97.6,2.4
던킨 연세안과병원점,42,40,2,95.2,4.8
매머드익스프레스 이대점,42,41,1,97.6,2.4
파스쿠찌 연세세브란스2호점,41,38,3,92.7,7.3
카우떡볶이,41,41,0,100.0,0.0
삼산회관 신촌점,41,40,1,97.6,2.4
아마,41,41,0,100.0,0.0
매머드익스프레스 신촌점,41,40,1,97.6,2.4
아마스빈 이대점,40,38,2,95.0,5.0
코쿤캅,40,40,0,100.0,0.0
김밥천국 신촌점,40,39,1,97.5,2.5
왓츠 유얼 컬러,40,39,1,97.5,2.5
섬채,39,39,0,100.0,0.0
더진국 수육국밥 신촌점,39,37,2,94.9,5.1
로봇김밥 세브란스점,39,38,1,97.4,2.6
본우리반상 신촌세브란스점,38,38,0,100.0,0.0
공차 이대역점,38,38,0,100.0,0.0
에어플레인모드,38,38,0,100.0,0.0
라 본느 타르트,37,36,1,97.3,2.7
탐앤탐스 신촌로터리점,37,36,1,97.3,2.7
볼타,37,37,0,100.0,0.0
프라이빗 신촌점,37,35,2,94.6,5.4
여우골초밥 신촌점,37,37,0,100.0,0.0
홍콩반점0410 신촌2호점,36,34,2,94.4,5.6
김가네김밥 이대점,36,35,1,97.2,2.8
주막보리밥,36,36,0,100.0,0.0
미스터서왕만두,35,35,0,100.0,0.0
유소바,35,35,0,100.0,0.0
샐러디 이화여대점,35,33,2,94.3,5.7
난향,34,34,0,100.0,0.0
제주도로담,34,34,0,100.0,0.0
컴포즈커피 신촌연세대점,34,32,2,94.1,5.9
배스킨라빈스 이대역,34,33,1,97.1,2.9
란주탕슉,33,32,1,97.0,3.0
해누리,33,33,0,100.0,0.0
백미당 현대백화점신촌점,32,31,1,96.9,3.1
waffle it up,32,32,0,100.0,0.0
엔타로커피,31,31,0,100.0,0.0
파스쿠찌 연세우리라운지점,31,31,0,100.0,0.0
더블랙나인,31,31,0,100.0,0.0
완차이,31,30,1,96.8,3.2
구구족 이대점,31,30,1,96.8,3.2
아소비바,31,31,0,100.0,0.0
아콘스톨,31,31,0,100.0,0.0
공릉닭한마리,30,29,1,96.7,3.3
김덕후의 차돌조,30,30,0,100.0,0.0
쭈꾸미블루스 신촌본점,30,29,1,96.7,3.3
설레임삼겹살,30,30,0,100.0,0.0
댓커피,30,30,0,100.0,0.0
샐러디 연세대점,29,28,1,96.6,3.4
고냉지,29,29,0,100.0,0.0
인쌩맥주 신촌점,29,26,3,89.7,10.3
이삭토스트 이화여대점,29,29,0,100.0,0.0
현명식탁,29,29,0,100.0,0.0
텐동미세기,29,28,1,96.6,3.4
쥬씨 신촌점,28,26,2,92.9,7.1
가츠벤또,28,28,0,100.0,0.0
싸움의고수 신촌점,28,27,1,96.4,3.6
101번지남산돈까스 현대백화점 신촌점,27,24,3,88.9,11.1
아웃닭 신촌역점,27,26,1,96.3,3.7
히노키공방,27,27,0,100.0,0.0
타코로코,27,26,1,96.3,3.7
홍두깨칼국수,27,27,0,100.0,0.0
역전할머니맥주 신촌점,26,26,0,100.0,0.0
클럽이스케이프,26,25,1,96.2,3.8
철길왕갈비살,26,25,1,96.2,3.8
보울룸 신촌점,26,26,0,100.0,0.0
두끼 이대점,26,23,3,88.5,11.5
거북이의주방,26,26,0,100.0,0.0
커피도가 헤리티지 신촌이대점,25,23,2,92.0,8.0
가화만사성,25,23,2,92.0,8.0
매거진 스탠딩,25,25,0,100.0,0.0
이국장,25,25,0,100.0,0.0
페리윙클,25,25,0,100.0,0.0
미분당 홍대점,25,25,0,100.0,0.0
행복은간장밥 신촌명물거리점,25,23,2,92.0,8.0
산울림1992,25,23,2,92.0,8.0
도넛킬러 현대백화점신촌점,24,22,2,91.7,8.3
미도인 신촌,24,23,1,95.8,4.2
건륭산시도삭면 신촌본점,24,24,0,100.0,0.0
김광석신촌칼국수 이대직영점,24,24,0,100.0,0.0
아워즈,24,23,1,95.8,4.2
신룽푸마라탕 신촌점,24,17,7,70.8,29.2
신룽푸마라탕 이대점,24,24,0,100.0,0.0
데이지,24,23,1,95.8,4.2
이디야커피 연세대점,24,23,1,95.8,4.2
뚜레쥬르 이화여대ECC점,23,21,2,91.3,8.7
천진분식,23,22,1,95.7,4.3
한강로칼국수 현대백화점 신촌점,23,23,0,100.0,0.0
식탁 하늬솔점,23,23,0,100.0,0.0
모센즈스위트 이대점,23,23,0,100.0,0.0
파리바게뜨 연대이화점,22,21,1,95.5,4.5
고스트요거트 이대점,22,22,0,100.0,0.0
혼신꼬치,22,21,1,95.5,4.5
아저씨네낙지찜,22,22,0,100.0,0.0
유야케도쿄,22,22,0,100.0,0.0
신촌부추곱창 신촌본점,22,19,3,86.4,13.6
본죽&비빔밥cafe 신촌점,22,21,1,95.5,4.5
이빠네마 그릴,22,22,0,100.0,0.0
고삼이 신촌점,22,22,0,100.0,0.0
Chai797 Plus 현대신촌점,22,22,0,100.0,0.0
고피자 신촌1호점,21,21,0,100.0,0.0
금별맥주 신촌점,21,19,2,90.5,9.5
포가레 신촌점,21,20,1,95.2,4.8
무사시,21,21,0,100.0,0.0
포히엔베트남쌀국수,21,21,0,100.0,0.0
틈새라면 신촌점,21,21,0,100.0,0.0
딸기골,21,21,0,100.0,0.0
모미지식당,20,18,2,90.0,10.0
꼼보포차 신촌2호점,20,20,0,100.0,0.0
이디야커피 이화여대점,20,20,0,100.0,0.0
신소살,20,20,0,100.0,0.0
백순대본가새맛 신촌연대점,20,20,0,100.0,0.0
파파노다이닝,20,20,0,100.0,0.0
내사랑,20,20,0,100.0,0.0
오늘닭강정 동교동삼거리점,19,18,1,94.7,5.3
이디야 신촌기차역점,19,19,0,100.0,0.0
뜸들이다 신촌점,19,17,2,89.5,10.5
유원섬커피,19,16,3,84.2,15.8
한림돈가 본점,19,16,3,84.2,15.8
에일크루,19,19,0,100.0,0.0
피자클럽,19,18,1,94.7,5.3
다미손칼국수,18,18,0,100.0,0.0
다다,18,18,0,100.0,0.0
몰리스,18,18,0,100.0,0.0
이화당제과,18,17,1,94.4,5.6
양꽃 오마카세 신촌점,18,17,1,94.4,5.6
더브레드블루 신촌본점,18,17,1,94.4,5.6
교촌치킨 신촌점,18,18,0,100.0,0.0
본죽 이대점,18,18,0,100.0,0.0
돈천동식당,18,18,0,100.0,0.0
라장훠궈,18,17,1,94.4,5.6
그레인바운더리 신촌점,18,18,0,100.0,0.0
구이마을,18,18,0,100.0,0.0
7번가피자 신촌마포점,18,18,0,100.0,0.0
새마을식당 신촌점,17,16,1,94.1,5.9
맨도롱 식당,17,15,2,88.2,11.8
에이투지 카페,17,17,0,100.0,0.0
투다리 신촌1호점,17,16,1,94.1,5.9
대치영지,17,16,1,94.1,5.9
옥루몽 신촌본점,17,17,0,100.0,0.0
부엉이돈가스 신촌점,17,15,2,88.2,11.8
공차 이대익스프레스점,17,17,0,100.0,0.0
베어스덴 브런치,17,16,1,94.1,5.9
누들김밥 이대점,17,17,0,100.0,0.0
3F CAFE,17,16,1,94.1,5.9
코다차야 신촌점,17,17,0,100.0,0.0
카페페라유니크,17,15,2,88.2,11.8
할리스 이대점,17,17,0,100.0,0.0
신촌돈부리모노,16,16,0,100.0,0.0
포트캔커피 신촌점,16,15,1,93.8,6.2
이삭토스트 창천점,16,16,0,100.0,0.0
무교동낙지 신촌점,16,16,0,100.0,0.0
마포돼지불백,16,16,0,100.0,0.0
BHC치킨 이대역점,16,15,1,93.8,6.2
이로운밥상,16,16,0,100.0,0.0
유채우 요리사랑,16,16,0,100.0,0.0
포석정,16,16,0,100.0,0.0
원즈오운,16,15,1,93.8,6.2
전티마이베트남쌀국수 이화여대점,16,16,0,100.0,0.0
타코몽,16,15,1,93.8,6.2
하우스라운지,16,16,0,100.0,0.0
교토우마이,16,16,0,100.0,0.0
이나닭강정 신촌점,16,16,0,100.0,0.0
오븐에오분,15,15,0,100.0,0.0
오시리야,15,15,0,100.0,0.0
까이식당,15,15,0,100.0,0.0
챔스빈커피 신촌점,15,15,0,100.0,0.0
사워도우 랩,15,15,0,100.0,0.0
헐리우드,15,15,0,100.0,0.0
렌게,15,15,0,100.0,0.0
오리지날 이대본점,15,14,1,93.3,6.7
카페 문베어,15,15,0,100.0,0.0
불타는곱창 신촌점,15,15,0,100.0,0.0
솔리드웍스 아이스크림,15,14,1,93.3,6.7
라임,15,14,1,93.3,6.7
청년밥상문간 이화여자대학교점,14,14,0,100.0,0.0
화로상회 신촌점,14,14,0,100.0,0.0
청년다방 신촌점,14,13,1,92.9,7.1
만추 현대백화점신촌점,14,14,0,100.0,0.0
짚신매운갈비찜 신촌점,14,14,0,100.0,0.0
루나틱커피,14,14,0,100.0,0.0
지파시 연세암병원점,14,13,1,92.9,7.1
홀리몰리,14,14,0,100.0,0.0
벨라프라하,14,14,0,100.0,0.0
가빈카페,14,14,0,100.0,0.0
빅타이니,14,14,0,100.0,0.0
코바코 신촌점,14,14,0,100.0,0.0
형제식당,14,14,0,100.0,0.0
파티오,14,14,0,100.0,0.0
명성양꼬치 신촌본점,14,14,0,100.0,0.0
삼진식당,14,12,2,85.7,14.3
도토리칼국수,13,12,1,92.3,7.7
찰리주막 신촌점,13,13,0,100.0,0.0
뉴욕비앤씨 신촌본점,13,13,0,100.0,0.0
풍국면 현대백화점 신촌점,13,10,3,76.9,23.1
초코블로썸,13,13,0,100.0,0.0
바프로,13,12,1,92.3,7.7
효동각 본점,13,13,0,100.0,0.0
지지고 이대점,13,13,0,100.0,0.0
보스포차,13,13,0,100.0,0.0
제임스시카고피자 신촌점,13,13,0,100.0,0.0
신촌고기창고,13,13,0,100.0,0.0
치즈를사랑한찜닭 신촌본점,13,13,0,100.0,0.0
전골떡볶이 덕미가 이대본점,13,12,1,92.3,7.7
포메인 신촌점,13,13,0,100.0,0.0
미사일부대찌개,13,12,1,92.3,7.7
홍콩식당 태흥빙실,13,12,1,92.3,7.7
돈불1971,13,13,0,100.0,0.0
인생식당,13,13,0,100.0,0.0
존재의 이유,13,13,0,100.0,0.0
신촌칼,13,13,0,100.0,0.0
삼미식당 신촌점,12,10,2,83.3,16.7
하노이의아침,12,12,0,100.0,0.0
온밥,12,12,0,100.0,0.0
막걸리싸롱,12,12,0,100.0,0.0
네네치킨 이대역점,12,12,0,100.0,0.0
비아 메렝게,12,10,2,83.3,16.7
카페슬래시,12,12,0,100.0,0.0
단데농,12,12,0,100.0,0.0
미네르바,12,11,1,91.7,8.3
원앤온리커피,12,12,0,100.0,0.0
와우끝집,12,11,1,91.7,8.3
쥬씨 이대점,12,11,1,91.7,8.3
공복식당,12,12,0,100.0,0.0
너스레,12,12,0,100.0,0.0
신촌브루스,11,11,0,100.0,0.0
카페파파,11,8,3,72.7,27.3
피자보이시나 신촌점,11,11,0,100.0,0.0
소담식당,11,11,0,100.0,0.0
삼호복집,11,10,1,90.9,9.1
안테이쿠,11,11,0,100.0,0.0
패스트카페 신촌점,11,11,0,100.0,0.0
준코 연세대점,11,10,1,90.9,9.1
유자유김치떡볶이 신촌점,11,11,0,100.0,0.0
카페문,11,11,0,100.0,0.0
술익는마을,11,11,0,100.0,0.0
호복,11,11,0,100.0,0.0
폼프리츠 신촌점,11,11,0,100.0,0.0
카페마지오,11,11,0,100.0,0.0
더도이축산직영점 신촌점,11,11,0,100.0,0.0
죽해수산,11,11,0,100.0,0.0
카페프루티,11,11,0,100.0,0.0
하노이포 본점,11,11,0,100.0,0.0
자연담은화로 신촌점,11,11,0,100.0,0.0
고기랑,11,11,0,100.0,0.0
조선의 육개장 칼국수,11,10,1,90.9,9.1
진저브라운,11,11,0,100.0,0.0
진돈부리,11,11,0,100.0,0.0
길상양꼬치,10,10,0,100.0,0.0
연대포,10,10,0,100.0,0.0
자마버거 이대점,10,10,0,100.0,0.0
웅네서서갈비,10,10,0,100.0,0.0
리화인아이스크림와플,10,10,0,100.0,0.0
홍미닭발 신촌점,10,9,1,90.0,10.0
이가네설렁탕,10,10,0,100.0,0.0
카츠미,10,10,0,100.0,0.0
카페 플레이스,10,9,1,90.0,10.0
꽃피다이화다방,10,10,0,100.0,0.0
개미집 신촌점,10,8,2,80.0,20.0
구복,10,10,0,100.0,0.0
카페봄봄 이화여대점,10,10,0,100.0,0.0
여래여거,10,9,1,90.0,10.0
백암순대국,10,9,1,90.0,10.0
라티노커피 이대점,10,10,0,100.0,0.0
팔색콩불,10,10,0,100.0,0.0
계백집 현대백화점 신촌점,10,10,0,100.0,0.0
리틀쿠바 현대백화점유플렉스신촌점,10,10,0,100.0,0.0
진미오향왕족발,10,10,0,100.0,0.0
화가와요리사,10,9,1,90.0,10.0
크리스터 치킨,10,10,0,100.0,0.0
스튜디오웝,10,10,0,100.0,0.0
두블레,10,9,1,90.0,10.0
모리츠플라츠,9,9,0,100.0,0.0
투다리 이대점,9,9,0,100.0,0.0
배떡 신촌점,9,9,0,100.0,0.0
소오밥집,9,9,0,100.0,0.0
화명당마라탕,9,9,0,100.0,0.0
지오짱조개구이,9,9,0,100.0,0.0
크로플덕오리아가씨 신촌점,9,9,0,100.0,0.0
정정아식당 신촌직영점,9,9,0,100.0,0.0
코지라운지,9,9,0,100.0,0.0
전주파전,9,9,0,100.0,0.0
요이스시,9,9,0,100.0,0.0
노란집,9,9,0,100.0,0.0
마라탕 이대6호점,9,9,0,100.0,0.0
이름없는파스타 이화여대점,9,9,0,100.0,0.0
의원상 이대점,9,9,0,100.0,0.0
남도밥상,9,9,0,100.0,0.0
참참참,9,9,0,100.0,0.0
Quid,9,9,0,100.0,0.0
종로김밥 신촌역점,9,9,0,100.0,0.0
원조감자탕,9,9,0,100.0,0.0
신의주찹쌀순대 신촌점,9,7,2,77.8,22.2
신촌간이회집,9,8,1,88.9,11.1
봉구비어 신촌명물거리2호점,9,9,0,100.0,0.0
프롬하츠커피 신촌점,9,9,0,100.0,0.0
아비꼬 이대점,9,8,1,88.9,11.1
유,9,9,0,100.0,0.0
타이완소야 신촌본점,9,9,0,100.0,0.0
청년국수,8,8,0,100.0,0.0
통통돼지,8,8,0,100.0,0.0
동해해물탕,8,7,1,87.5,12.5
대포,8,8,0,100.0,0.0
나주곰탕냉면 본점,8,8,0,100.0,0.0
1987피자,8,8,0,100.0,0.0
빠빠빠치킨 연대본점,8,7,1,87.5,12.5
청담동포장마차,8,8,0,100.0,0.0
고래파스타,8,8,0,100.0,0.0
한울타리,8,8,0,100.0,0.0
살롱드느루,8,8,0,100.0,0.0
육회본가 신촌점,8,8,0,100.0,0.0
신촌해물칼국수,8,8,0,100.0,0.0
김사부 브런치&지엔빙,8,8,0,100.0,0.0
신촌귀일만두,8,7,1,87.5,12.5
만냥하우스,8,8,0,100.0,0.0
엠아이스위트,8,8,0,100.0,0.0
홍곱창 신촌점,8,8,0,100.0,0.0
봉추찜닭 신촌점,8,7,1,87.5,12.5
아무술집 신촌점,8,8,0,100.0,0.0
소도적,8,7,1,87.5,12.5
피자스쿨 이대점,8,8,0,100.0,0.0
카페코지 이화여대점,8,7,1,87.5,12.5
피망과토마토,8,7,1,87.5,12.5
육쌈냉면 이대점,8,8,0,100.0,0.0
굿바이슈가베어 포케&샐러드,8,8,0,100.0,0.0
베러댄와플 이화여대점,8,8,0,100.0,0.0
동해횟집,8,8,0,100.0,0.0
파스타리코 신촌점,8,8,0,100.0,0.0
veganique,8,7,1,87.5,12.5
불밥 이대본점,8,8,0,100.0,0.0
보그,8,8,0,100.0,0.0
릴리우드,8,7,1,87.5,12.5
라플로르,8,8,0,100.0,0.0
야채를담다,8,8,0,100.0,0.0
라멘81번옥 신촌점,8,8,0,100.0,0.0
마포깐풍기,8,8,0,100.0,0.0
사백집 서울대패 신촌점,8,8,0,100.0,0.0
탐복 현대백화점신촌점,8,8,0,100.0,0.0
이대깻잎떡볶이,8,8,0,100.0,0.0
한우곱창,8,8,0,100.0,0.0
돌아온의정부부대찌개,8,5,3,62.5,37.5
신참떡볶이 이대점,7,7,0,100.0,0.0
위블레,7,7,0,100.0,0.0
로드샌드위치,7,7,0,100.0,0.0
멜브라운 미트파이,7,7,0,100.0,0.0
이코노스시본점,7,7,0,100.0,0.0
신촌영양센터,7,7,0,100.0,0.0
영심이네감자탕,7,7,0,100.0,0.0
카페HE,7,7,0,100.0,0.0
낮과밤,7,7,0,100.0,0.0
이자카야 류 2호점,7,5,2,71.4,28.6
리또리또,7,7,0,100.0,0.0
대현매운족발 본점,7,7,0,100.0,0.0
오리총재 신촌점,7,7,0,100.0,0.0
정오아카데미 이화여대점,7,7,0,100.0,0.0
아메노히 커피점,7,7,0,100.0,0.0
헤븐,7,7,0,100.0,0.0
동강참치,7,6,1,85.7,14.3
써밋컬쳐 신촌,7,5,2,71.4,28.6
반이학생마라탕마라반,7,7,0,100.0,0.0
초당쌈밥,7,7,0,100.0,0.0
과일에반하다 프루타 신촌점,7,7,0,100.0,0.0
군자대한곱창 신촌점,7,7,0,100.0,0.0
뉴타운,7,7,0,100.0,0.0
굽네치킨 신촌점,7,7,0,100.0,0.0
다모토리,7,7,0,100.0,0.0
장미맨숀 신촌점,7,7,0,100.0,0.0
라이프커피컴퍼니,7,7,0,100.0,0.0
플릭온커피,7,7,0,100.0,0.0
아비꼬 신촌점,7,7,0,100.0,0.0
기중상점,7,7,0,100.0,0.0
죠티레스토랑,7,7,0,100.0,0.0
카페모나티,7,7,0,100.0,0.0
씽킹인사이드더박스,7,6,1,85.7,14.3
야키토리연,7,7,0,100.0,0.0
연어상회 신촌점,7,6,1,85.7,14.3
소우 오뎅,7,6,1,85.7,14.3
강릉아구찜,6,6,0,100.0,0.0
청년순대국 이화여대점,6,5,1,83.3,16.7
로컬식당,6,6,0,100.0,0.0
디델리 이대점,6,6,0,100.0,0.0
카페자리,6,6,0,100.0,0.0
고래고래신촌점,6,5,1,83.3,16.7
춘풍식리양꼬치,6,6,0,100.0,0.0
키친31,6,6,0,100.0,0.0
마이시크릿메이트,6,6,0,100.0,0.0
대구삼겹살,6,6,0,100.0,0.0
자담치킨 신촌점,6,6,0,100.0,0.0
바 코디얼,6,6,0,100.0,0.0
포텅즈,6,5,1,83.3,16.7
소문난집,6,5,1,83.3,16.7
콩불 신촌점,6,6,0,100.0,0.0
논지당,6,5,1,83.3,16.7
우드문,6,6,0,100.0,0.0
펀비어킹 신촌 유플렉스점,6,6,0,100.0,0.0
티문 카페,6,6,0,100.0,0.0
팔팔쌈닭,6,6,0,100.0,0.0
설맥 신촌점,5,5,0,100.0,0.0
신촌양꼬치,5,5,0,100.0,0.0
통큰 장모님 밥상,5,5,0,100.0,0.0
홍초불닭 신촌본점,5,5,0,100.0,0.0
구이마을 2호점,5,5,0,100.0,0.0
정원식당,5,5,0,100.0,0.0
판자집,5,5,0,100.0,0.0
통인동커피공방 신촌로스팅라이브러리,5,5,0,100.0,0.0
체셔캣,5,4,1,80.0,20.0
김덕후의곱창조 신촌점,5,5,0,100.0,0.0
인도야시장 신촌점,5,5,0,100.0,0.0
나주식당,5,5,0,100.0,0.0
신촌관,5,5,0,100.0,0.0
이자카야류 3호점,5,5,0,100.0,0.0
정육면체,5,5,0,100.0,0.0
라마커피,5,5,0,100.0,0.0
함평면옥,5,2,3,40.0,60.0
바코드,5,5,0,100.0,0.0
제순식당 연세대SK국제학사점,5,5,0,100.0,0.0
미도 매운향솥,5,5,0,100.0,0.0
장군찜닭,5,5,0,100.0,0.0
신촌갈매기,5,4,1,80.0,20.0
108장 마라탕,5,5,0,100.0,0.0
해신포차,5,5,0,100.0,0.0
지코바치킨 신촌점,5,5,0,100.0,0.0
라이프롱드림 코지라운지,5,5,0,100.0,0.0
단골손님 신촌점,5,4,1,80.0,20.0
낭만식탁,5,5,0,100.0,0.0
갈라파라멘 정성드림,5,5,0,100.0,0.0
오늘와인한잔 연대가든점,4,4,0,100.0,0.0
사케즈키,4,4,0,100.0,0.0
1943 신촌점,4,4,0,100.0,0.0
BHC치킨 신촌점,4,4,0,100.0,0.0
만남양꼬치,4,4,0,100.0,0.0
육칠이 신촌점,4,4,0,100.0,0.0
대박황소곱창,4,4,0,100.0,0.0
엘라도수제아이스크림,4,4,0,100.0,0.0
2대족발,4,4,0,100.0,0.0
클로버,4,4,0,100.0,0.0
송학,4,4,0,100.0,0.0
떡군이네떡볶이 홍대신촌점,4,4,0,100.0,0.0
고바우,4,4,0,100.0,0.0
와인집,4,4,0,100.0,0.0
예소원,4,4,0,100.0,0.0
가마마루이라멘,4,4,0,100.0,0.0
스시가마시 이대점,4,4,0,100.0,0.0
에그 앤드 스푼레이스,4,4,0,100.0,0.0
치즈문,4,4,0,100.0,0.0
앨리스,4,4,0,100.0,0.0
팜스힐,4,4,0,100.0,0.0
타코마씸 신촌점,4,4,0,100.0,0.0
잉치킨 신촌점,4,4,0,100.0,0.0
피자나라치킨공주 신촌점,4,4,0,100.0,0.0
달리는커피 신촌역점,4,4,0,100.0,0.0
압구정샤브샤브 신촌점,4,4,0,100.0,0.0
치킨더홈 서울이대점,4,4,0,100.0,0.0
두찜 신촌점,4,4,0,100.0,0.0
아임요거트&아이스크림 이화점,4,4,0,100.0,0.0
두꺼비로멘스 신촌점,4,3,1,75.0,25.0
가마골,4,4,0,100.0,0.0
명물갈비,4,4,0,100.0,0.0
무교동낙지골,4,4,0,100.0,0.0
시오램,4,4,0,100.0,0.0
독수리상회,4,4,0,100.0,0.0
남도벌교음식점,4,4,0,100.0,0.0
신화장,4,4,0,100.0,0.0
크림온케이크,4,4,0,100.0,0.0
한신포차 신촌점,4,3,1,75.0,25.0
one of c,4,4,0,100.0,0.0
이자카야 류,4,4,0,100.0,0.0
육연소,4,4,0,100.0,0.0
언니네양식당,4,4,0,100.0,0.0
제주돈1848,4,3,1,75.0,25.0
따띠삼겹 이대점,4,4,0,100.0,0.0
대명꼬기,4,4,0,100.0,0.0
마이도야 현대백화점신촌점,4,4,0,100.0,0.0
전주식당,3,3,0,100.0,0.0
세아마라탕,3,3,0,100.0,0.0
이태리마담 신촌점,3,2,1,66.7,33.3
롤러프레시,3,3,0,100.0,0.0
Dana Bakeshop,3,3,0,100.0,0.0
우드스탁,3,3,0,100.0,0.0
홍대24시스파 스낵,3,3,0,100.0,0.0
아키,3,3,0,100.0,0.0
버블티킹 신촌점,3,3,0,100.0,0.0
벽제갈비 신촌점,3,1,2,33.3,66.7
중국산서찜면,3,3,0,100.0,0.0
신미불닭발,3,3,0,100.0,0.0
올그릭투미,3,3,0,100.0,0.0
제스의부엌 옐로서브마린점,3,3,0,100.0,0.0
크라운호프 신촌점,3,3,0,100.0,0.0
태백산맥,3,3,0,100.0,0.0
코비노래타운 신촌점,3,3,0,100.0,0.0
섬진강민물장어,3,3,0,100.0,0.0
한옥숯불돼지갈비,3,3,0,100.0,0.0
오렌지룸 신촌점,3,3,0,100.0,0.0
한바가지,3,3,0,100.0,0.0
아마이,3,2,1,66.7,33.3
젊음의행진,3,3,0,100.0,0.0
쉬바펍,3,3,0,100.0,0.0
맥주바다,3,3,0,100.0,0.0
마미골,3,3,0,100.0,0.0
잠바주스 연세대학교점,3,3,0,100.0,0.0
파스쿠찌 연세심혈관병원점,3,2,1,66.7,33.3
담,3,3,0,100.0,0.0
썬더치킨 신촌연대점,3,3,0,100.0,0.0
카라멘야,3,3,0,100.0,0.0
호밀밭,3,3,0,100.0,0.0
그릭데이이대본점,3,3,0,100.0,0.0
Messier,3,3,0,100.0,0.0
에일크루브루잉 신촌점,3,3,0,100.0,0.0
다발김치찌개,3,3,0,100.0,0.0
곱창이야기,3,3,0,100.0,0.0
신촌설렁탕,3,2,1,66.7,33.3
향꽃,3,3,0,100.0,0.0
오늘와인한잔 이대역점,3,3,0,100.0,0.0
카페앤 신촌점,3,3,0,100.0,0.0
네오치킨 신촌점,3,3,0,100.0,0.0
신촌김치삼겹살,3,3,0,100.0,0.0
카페아늑,3,3,0,100.0,0.0
엄마손김밥,3,2,1,66.7,33.3
덮밥만드는남자 이대점,3,2,1,66.7,33.3
쏙만두,2,2,0,100.0,0.0
맛있는식사,2,2,0,100.0,0.0
돈카춘 이대점,2,2,0,100.0,0.0
청화원,2,2,0,100.0,0.0
신촌황소곱창,2,1,1,50.0,50.0
꼬숑돈까스,2,2,0,100.0,0.0
카츠업,2,2,0,100.0,0.0
히마진,2,2,0,100.0,0.0
파이홀,2,2,0,100.0,0.0
타이스토리,2,2,0,100.0,0.0
와플덴 이대정문점,2,2,0,100.0,0.0
본도시락 이대점,2,2,0,100.0,0.0
담산신촌본점,2,2,0,100.0,0.0
파가니니,2,2,0,100.0,0.0
베이직프라이드치킨 신촌직영점,2,2,0,100.0,0.0
대족장,2,2,0,100.0,0.0
SOLID ACE,2,2,0,100.0,0.0
정승찬임대사업,2,2,0,100.0,0.0
야마노라멘,2,2,0,100.0,0.0
북카페파오,2,2,0,100.0,0.0
싱싱참치,2,2,0,100.0,0.0
동네아저씨 신촌점,2,2,0,100.0,0.0
냥 보드게임pub,2,2,0,100.0,0.0
더숲키친,2,2,0,100.0,0.0
마포등심,2,2,0,100.0,0.0
신촌다성수산,2,2,0,100.0,0.0
민주네 김밥,2,2,0,100.0,0.0
밥이꿀바비꿀,2,2,0,100.0,0.0
막퍼주는집,2,2,0,100.0,0.0
악동포차,2,2,0,100.0,0.0
투썸플레이스 신촌기차역점,2,2,0,100.0,0.0
춘삼국수,2,2,0,100.0,0.0
돈노코돈먹기 이대점,2,2,0,100.0,0.0
ATTA,2,2,0,100.0,0.0
카페스페이스,2,2,0,100.0,0.0
히우카우,2,2,0,100.0,0.0
샌드프레소 연대동문점,2,2,0,100.0,0.0
예스터데이,2,2,0,100.0,0.0
바 틸트,2,2,0,100.0,0.0
쭈꾸미달인 신촌점,2,2,0,100.0,0.0
거품1,2,2,0,100.0,0.0
젊은소나무,2,2,0,100.0,0.0
동학물갈비,2,2,0,100.0,0.0
작은카페,2,2,0,100.0,0.0
통통닭,2,2,0,100.0,0.0
대포찜닭,2,2,0,100.0,0.0
양,2,2,0,100.0,0.0
낭만포차노가리,2,2,0,100.0,0.0
휴카페,2,1,1,50.0,50.0
걸작떡볶이치킨 신촌점,2,2,0,100.0,0.0
라운딩,2,2,0,100.0,0.0
일미리금계찜닭 신촌점,1,1,0,100.0,0.0
신촌오빠네옛날떡볶이,1,1,0,100.0,0.0
한창희천하일면,1,1,0,100.0,0.0
가례원,1,1,0,100.0,0.0
꽁술,1,1,0,100.0,0.0
인생이막창이네,1,1,0,100.0,0.0
LP시대,1,1,0,100.0,0.0
야바이,1,1,0,100.0,0.0
푸른바다찜탕,1,1,0,100.0,0.0
비어어클락,1,1,0,100.0,0.0
소주밤,1,1,0,100.0,0.0
아무 (Amu),1,1,0,100.0,0.0
카페언더우드,1,1,0,100.0,0.0
김밥천국,1,1,0,100.0,0.0
삼미마라탕,1,1,0,100.0,0.0
비밀,1,1,0,100.0,0.0
신신포차,1,1,0,100.0,0.0
논탄토,1,1,0,100.0,0.0
신촌수제비,1,1,0,100.0,0.0
통큰갈비신촌본점,1,1,0,100.0,0.0
위샐러듀이대점,1,1,0,100.0,0.0
신계치라면,1,1,0,100.0,0.0
다트펍 신촌상회,1,1,0,100.0,0.0
홍대돈부리 신촌점,1,1,0,100.0,0.0
생육회관,1,1,0,100.0,0.0
배바위양곱창,1,1,0,100.0,0.0
김판석초밥,1,1,0,100.0,0.0
우리이동갈비,1,1,0,100.0,0.0
네이버후드,1,1,0,100.0,0.0
프레퍼스다이어트푸드,1,1,0,100.0,0.0
유닭스토리닭한마리신촌점,1,1,0,100.0,0.0
쿠마네꼬치,1,1,0,100.0,0.0
더블유루프탑,1,1,0,100.0,0.0
아임카츠,1,1,0,100.0,0.0
북카페/서점 피터캣,1,1,0,100.0,0.0
꼬뜨 레스토랑,1,1,0,100.0,0.0
디저트샵 이브흐,1,1,0,100.0,0.0
플로루스,1,1,0,100.0,0.0
수퍼파인,1,1,0,100.0,0.0
강산애,1,1,0,100.0,0.0
산타비,1,1,0,100.0,0.0
예체능,1,1,0,100.0,0.0
햅윗버터,1,1,0,100.0,0.0
포크라이언 커피,1,1,0,100.0,0.0
잭아저씨족발&보쌈 홍대점,1,1,0,100.0,0.0
훼드라,1,1,0,100.0,0.0
the Panini,1,1,0,100.0,0.0
항아리분식,1,1,0,100.0,0.0
일품92하우스,1,1,0,100.0,0.0
세븐레드 홀덤펍 신촌점,1,1,0,100.0,0.0
순살만공격 마포신촌점,1,1,0,100.0,0.0
베리베리솔티,1,1,0,100.0,0.0
쿠리야,1,1,0,100.0,0.0
허니꼬꼬,1,1,0,100.0,0.0
카페달빛,1,1,0,100.0,0.0
처갓집양념치킨 신촌점,1,1,0,100.0,0.0
로프트,1,1,0,100.0,0.0
카시타 후카바 신촌점,1,1,0,100.0,0.0
책다방 위숨,1,1,0,100.0,0.0
카페 지니,1,1,0,100.0,0.0
서변동 마늘 떡볶이,1,1,0,100.0,0.0
레인트리,1,1,0,100.0,0.0
카페 시크릿,1,1,0,100.0,0.0
"육회, 꽃피다",1,1,0,100.0,0.0
후쿠스시,1,1,0,100.0,0.0
다모토리5,1,1,0,100.0,0.0
이 세계는 놀이터예요,1,1,0,100.0,0.0
까미네 닭강정,1,1,0,100.0,0.0
커피콩즙,1,1,0,100.0,0.0
고향,1,1,0,100.0,0.0
