호텔,리뷰 개수,긍정 리뷰 개수,부정 리뷰 개수,긍정 리뷰 비율,부정 리뷰 비율
지니네컵밥,224,224,0,100.0,0.0
독립문설렁탕,180,169,11,93.9,6.1
플라페,178,176,2,98.9,1.1
탈리,167,165,2,98.8,1.2
천궁전마라탕,142,142,0,100.0,0.0
기꾸스시,135,131,4,97.0,3.0
마더린러 베이글,131,126,5,96.2,3.8
영미김밥,124,122,2,98.4,1.6
형제갈비,121,113,8,93.4,6.6
투썸플레이스 이대역점,121,114,7,94.2,5.8
잠바주스 연세세브란스점,119,111,8,93.3,6.7
커피크레페본점,115,115,0,100.0,0.0
김진환 제과점,110,110,0,100.0,0.0
매머드익스프레스 신촌점,108,107,1,99.1,0.9
팔공티 신촌점,108,106,2,98.1,1.9
메가MGC커피 창천점,108,106,2,98.1,1.9
고르드,104,102,2,98.1,1.9
왓츠 유얼 컬러,104,103,1,99.0,1.0
맘스터치 이대점,103,101,2,98.1,1.9
대끼리 돈까스,101,101,0,100.0,0.0
메가MGC커피 신촌로터리점,100,100,0,100.0,0.0
포가레 신촌점,99,99,0,100.0,0.0
타오마라탕 신촌점,98,98,0,100.0,0.0
코쿤캅,96,80,16,83.3,16.7
포베이 연세암병원점,96,85,11,88.5,11.5
보승회관 서울신촌점,94,92,2,97.9,2.1
빽다방 신촌역점,93,89,4,95.7,4.3
역전우동0410 신촌점,91,91,0,100.0,0.0
파리바게뜨 카페이대역점,87,82,5,94.3,5.7
팔공티 이대점,84,83,1,98.8,1.2
아마스빈 이대점,82,82,0,100.0,0.0
미분당 홍대점,81,81,0,100.0,0.0
이디야커피 신촌역점,80,78,2,97.5,2.5
이삭토스트 서울신촌점,80,78,2,97.5,2.5
사장님돈까스 이화여대점,80,80,0,100.0,0.0
돈우마미,79,79,0,100.0,0.0
백년당 마라탕 본점,78,78,0,100.0,0.0
소신이쏘 신촌본점,78,78,0,100.0,0.0
고향전주비빔밥 현대백화점신촌점,78,75,3,96.2,3.8
컴포즈커피 신촌연세대점,77,76,1,98.7,1.3
매머드익스프레스 이대점,76,75,1,98.7,1.3
브릭스5221맥주 신촌점,75,74,1,98.7,1.3
유소바,75,73,2,97.3,2.7
또보겠지떡볶이집 신촌히어로점,75,75,0,100.0,0.0
소바연구소,74,73,1,98.6,1.4
티앙팡 오후의 홍차,74,74,0,100.0,0.0
롯데리아 이대점,74,71,3,95.9,4.1
피슈마라홍탕 신촌점,73,73,0,100.0,0.0
삭 수제튀김 전문점,73,71,2,97.3,2.7
인타코타코야끼&캔카페,73,70,3,95.9,4.1
부탄츄 신촌점,73,72,1,98.6,1.4
돈까스대왕전 이대점,70,67,3,95.7,4.3
버거리 신촌점,69,66,3,95.7,4.3
본우리반상 신촌세브란스점,69,62,7,89.9,10.1
포티드,67,64,3,95.5,4.5
싸다김밥 신촌점,66,64,2,97.0,3.0
엠브로돈까스 신촌본점,65,63,2,96.9,3.1
타코벨 신촌점,64,62,2,96.9,3.1
방콕익스프레스 신촌본점,64,60,4,93.8,6.2
란주탕슉,63,62,1,98.4,1.6
스카이문 루프탑,62,62,0,100.0,0.0
대성이네,61,61,0,100.0,0.0
돈천동식당,61,61,0,100.0,0.0
연희김밥 신촌점,60,60,0,100.0,0.0
본죽 세브란스병원점,60,58,2,96.7,3.3
이디야커피 연세대점,60,59,1,98.3,1.7
구씨네부엌,60,60,0,100.0,0.0
롤링파스타 신촌점,58,56,2,96.6,3.4
김삼보김치찌개 신촌점,58,55,3,94.8,5.2
더블랙나인,57,56,1,98.2,1.8
샐러디 이화여대점,57,56,1,98.2,1.8
맘맘테이블,56,56,0,100.0,0.0
맛있는순두부&김치찜,56,49,7,87.5,12.5
던킨 연대동문회관점,56,55,1,98.2,1.8
역전할머니맥주 신촌점,56,52,4,92.9,7.1
복성각,55,55,0,100.0,0.0
김광석신촌칼국수 본점,55,52,3,94.5,5.5
비아37,54,53,1,98.1,1.9
헤이진,54,54,0,100.0,0.0
머노까머나 신촌점,53,53,0,100.0,0.0
라구식당,53,51,2,96.2,3.8
연세로갈매기,53,53,0,100.0,0.0
오늘통닭 신촌직영점,53,53,0,100.0,0.0
양꽃 오마카세 신촌점,52,52,0,100.0,0.0
전티마이베트남쌀국수 이화여대점,51,50,1,98.0,2.0
고스트요거트 이대점,51,51,0,100.0,0.0
waffle it up,50,49,1,98.0,2.0
주막보리밥,50,49,1,98.0,2.0
마녀주방 신촌점,49,48,1,98.0,2.0
할리스 이대점,49,48,1,98.0,2.0
씨유그릭,48,47,1,97.9,2.1
춘천집닭갈비본사직영철판구이,48,44,4,91.7,8.3
현명식탁,47,46,1,97.9,2.1
춘천집 닭갈비막국수,47,46,1,97.9,2.1
독수리다방,47,47,0,100.0,0.0
천진분식,47,46,1,97.9,2.1
난향,46,44,2,95.7,4.3
섬채,46,46,0,100.0,0.0
클로리스 신촌본점,46,44,2,95.7,4.3
공차 이대익스프레스점,46,45,1,97.8,2.2
아콘스톨,45,44,1,97.8,2.2
모센즈스위트 이대점,45,42,3,93.3,6.7
백순대본가새맛 신촌연대점,44,44,0,100.0,0.0
명륜진사갈비 서울신촌점,44,40,4,90.9,9.1
두끼 이대점,44,42,2,95.5,4.5
미스터서왕만두,44,43,1,97.7,2.3
에어플레인모드,43,43,0,100.0,0.0
뚜레쥬르 이화여대ECC점,42,42,0,100.0,0.0
이디야커피 이화여대점,42,40,2,95.2,4.8
유야케도쿄,42,40,2,95.2,4.8
교토우마이,42,41,1,97.6,2.4
옥희네 떡볶이,41,41,0,100.0,0.0
3F CAFE,41,40,1,97.6,2.4
단데농,40,39,1,97.5,2.5
공차 이대역점,40,36,4,90.0,10.0
다미손칼국수,40,40,0,100.0,0.0
홍콩반점0410 신촌2호점,40,36,4,90.0,10.0
카페나무,40,36,4,90.0,10.0
닥터로빈 이대점,39,39,0,100.0,0.0
렌게,39,39,0,100.0,0.0
카우떡볶이,39,39,0,100.0,0.0
공릉닭한마리,39,38,1,97.4,2.6
산울림1992,38,37,1,97.4,2.6
철길왕갈비살,38,37,1,97.4,2.6
던킨 연세안과병원점,38,36,2,94.7,5.3
구이마을,38,36,2,94.7,5.3
탐앤탐스 신촌로터리점,38,37,1,97.4,2.6
금별맥주 신촌점,38,32,6,84.2,15.8
쥬씨 이대점,37,36,1,97.3,2.7
로봇김밥 세브란스점,37,34,3,91.9,8.1
강남불백 신촌점,37,35,2,94.6,5.4
라 본느 타르트,36,36,0,100.0,0.0
더진국 수육국밥 신촌점,36,36,0,100.0,0.0
배스킨라빈스 이대역,36,35,1,97.2,2.8
오늘닭강정 동교동삼거리점,36,36,0,100.0,0.0
샐러디 연세대점,36,34,2,94.4,5.6
인쌩맥주 신촌점,35,34,1,97.1,2.9
아저씨네낙지찜,35,35,0,100.0,0.0
여우골초밥 신촌점,35,35,0,100.0,0.0
미도인 신촌,34,33,1,97.1,2.9
김밥천국 신촌점,34,32,2,94.1,5.9
싸움의고수 신촌점,34,33,1,97.1,2.9
호탕마라탕,34,33,1,97.1,2.9
화명당마라탕,33,32,1,97.0,3.0
포히엔베트남쌀국수,33,31,2,93.9,6.1
형제식당,33,33,0,100.0,0.0
고냉지,33,32,1,97.0,3.0
대파곱창,33,31,2,93.9,6.1
구구족 이대점,33,33,0,100.0,0.0
고삼이 신촌점,33,33,0,100.0,0.0
텐동미세기,32,32,0,100.0,0.0
돈불1971,32,32,0,100.0,0.0
홀리몰리,32,32,0,100.0,0.0
카페문,32,32,0,100.0,0.0
리히트,32,32,0,100.0,0.0
신룽푸마라탕 이대점,32,31,1,96.9,3.1
호복,31,27,4,87.1,12.9
김광석신촌칼국수 이대직영점,31,28,3,90.3,9.7
베어스덴 브런치,31,29,2,93.5,6.5
교촌치킨 신촌점,31,29,2,93.5,6.5
설레임삼겹살,31,31,0,100.0,0.0
신촌부추곱창 신촌본점,31,28,3,90.3,9.7
파스쿠찌 연세우리라운지점,30,30,0,100.0,0.0
룸의정석 신촌점,30,29,1,96.7,3.3
본죽 이대점,30,29,1,96.7,3.3
화로상회 신촌점,29,28,1,96.6,3.4
도토리칼국수,29,28,1,96.6,3.4
홍두깨칼국수,29,26,3,89.7,10.3
두블레,29,28,1,96.6,3.4
엔타로커피,28,28,0,100.0,0.0
매거진 스탠딩,28,27,1,96.4,3.6
7번가피자 신촌마포점,28,28,0,100.0,0.0
이국장,28,28,0,100.0,0.0
베러댄와플 이화여대점,28,28,0,100.0,0.0
아마,28,28,0,100.0,0.0
식탁 하늬솔점,28,28,0,100.0,0.0
파리바게뜨 연대이화점,28,25,3,89.3,10.7
대치영지,28,27,1,96.4,3.6
볼타,27,27,0,100.0,0.0
이화당제과,27,27,0,100.0,0.0
비아 메렝게,27,25,2,92.6,7.4
가화만사성,27,24,3,88.9,11.1
건륭산시도삭면 신촌본점,27,25,2,92.6,7.4
딸기골,27,25,2,92.6,7.4
뜸들이다 신촌점,27,25,2,92.6,7.4
누들김밥 이대점,27,27,0,100.0,0.0
댓커피,27,27,0,100.0,0.0
BHC치킨 이대역점,27,24,3,88.9,11.1
한림돈가 본점,26,24,2,92.3,7.7
카페페라유니크,26,26,0,100.0,0.0
아웃닭 신촌역점,26,26,0,100.0,0.0
새마을식당 신촌점,26,26,0,100.0,0.0
하노이의아침,26,26,0,100.0,0.0
부엉이돈가스 신촌점,26,25,1,96.2,3.8
혼신꼬치,26,26,0,100.0,0.0
풍국면 현대백화점 신촌점,26,25,1,96.2,3.8
시오램,26,26,0,100.0,0.0
쭈꾸미블루스 신촌본점,26,24,2,92.3,7.7
유자유김치떡볶이 신촌점,26,26,0,100.0,0.0
백미당 현대백화점신촌점,25,25,0,100.0,0.0
원즈오운,25,25,0,100.0,0.0
타코몽,25,25,0,100.0,0.0
루나틱커피,25,25,0,100.0,0.0
이로운밥상,25,25,0,100.0,0.0
웅네서서갈비,25,24,1,96.0,4.0
코다차야 신촌점,25,22,3,88.0,12.0
가츠벤또,24,24,0,100.0,0.0
청년다방 신촌점,24,22,2,91.7,8.3
101번지남산돈까스 현대백화점 신촌점,24,23,1,95.8,4.2
Chai797 Plus 현대신촌점,24,22,2,91.7,8.3
파파노다이닝,24,24,0,100.0,0.0
라티노커피 이대점,24,24,0,100.0,0.0
본죽&비빔밥cafe 신촌점,24,21,3,87.5,12.5
해누리,24,24,0,100.0,0.0
더브레드블루 신촌본점,23,20,3,87.0,13.0
타코로코,23,21,2,91.3,8.7
파스쿠찌 연세세브란스2호점,23,23,0,100.0,0.0
고피자 신촌1호점,23,22,1,95.7,4.3
이대깻잎떡볶이,23,22,1,95.7,4.3
술익는마을,23,21,2,91.3,8.7
커피도가 헤리티지 신촌이대점,23,23,0,100.0,0.0
다다,23,23,0,100.0,0.0
홍콩식당 태흥빙실,22,21,1,95.5,4.5
행복은간장밥 신촌명물거리점,22,22,0,100.0,0.0
소담식당,22,22,0,100.0,0.0
모미지식당,22,21,1,95.5,4.5
헐리우드,22,22,0,100.0,0.0
유,22,22,0,100.0,0.0
챔스빈커피 신촌점,22,21,1,95.5,4.5
제스의부엌 옐로서브마린점,21,21,0,100.0,0.0
삼진식당,21,21,0,100.0,0.0
불밥 이대본점,21,21,0,100.0,0.0
라임,21,21,0,100.0,0.0
원조감자탕,21,20,1,95.2,4.8
지파시 연세암병원점,21,21,0,100.0,0.0
전골떡볶이 덕미가 이대본점,21,21,0,100.0,0.0
너스레,21,20,1,95.2,4.8
신촌간이회집,21,18,3,85.7,14.3
연대포,21,20,1,95.2,4.8
쥬씨 신촌점,21,21,0,100.0,0.0
과일에반하다 프루타 신촌점,21,20,1,95.2,4.8
미네르바,21,20,1,95.2,4.8
신촌칼,21,21,0,100.0,0.0
신룽푸마라탕 신촌점,20,18,2,90.0,10.0
플릭온커피,20,20,0,100.0,0.0
오리지날 이대본점,20,17,3,85.0,15.0
청년순대국 이화여대점,20,20,0,100.0,0.0
오븐에오분,20,20,0,100.0,0.0
로컬식당,20,20,0,100.0,0.0
라멘81번옥 신촌점,20,20,0,100.0,0.0
옥루몽 신촌본점,20,19,1,95.0,5.0
진저브라운,20,20,0,100.0,0.0
소우 오뎅,19,18,1,94.7,5.3
김가네김밥 이대점,19,19,0,100.0,0.0
프라이빗 신촌점,19,16,3,84.2,15.8
금고기비스트로 신촌,19,19,0,100.0,0.0
보스포차,19,19,0,100.0,0.0
이름없는파스타 이화여대점,19,18,1,94.7,5.3
히노키공방,19,19,0,100.0,0.0
미사일부대찌개,19,17,2,89.5,10.5
108장 마라탕,19,18,1,94.7,5.3
존재의 이유,19,19,0,100.0,0.0
이삭토스트 이화여대점,19,19,0,100.0,0.0
몰리스,19,17,2,89.5,10.5
포메인 신촌점,19,17,2,89.5,10.5
리또리또,19,19,0,100.0,0.0
틈새라면 신촌점,19,19,0,100.0,0.0
무사시,19,17,2,89.5,10.5
빅타이니,18,17,1,94.4,5.6
효동각 본점,18,17,1,94.4,5.6
안테이쿠,18,17,1,94.4,5.6
투다리 이대점,18,15,3,83.3,16.7
클럽이스케이프,18,18,0,100.0,0.0
신촌귀일만두,18,18,0,100.0,0.0
스튜디오웝,18,18,0,100.0,0.0
오시리야,18,18,0,100.0,0.0
대현매운족발 본점,18,17,1,94.4,5.6
무교동낙지 신촌점,18,15,3,83.3,16.7
타이스토리,18,18,0,100.0,0.0
미도 매운향솥,18,16,2,88.9,11.1
청년밥상문간 이화여자대학교점,17,17,0,100.0,0.0
피자클럽,17,16,1,94.1,5.9
자마버거 이대점,17,16,1,94.1,5.9
까이식당,17,17,0,100.0,0.0
신촌관,17,17,0,100.0,0.0
개미집 신촌점,17,14,3,82.4,17.6
가빈카페,17,17,0,100.0,0.0
연어상회 신촌점,17,16,1,94.1,5.9
카츠미,17,16,1,94.1,5.9
이빠네마 그릴,17,16,1,94.1,5.9
카페파파,16,16,0,100.0,0.0
지지고 이대점,16,16,0,100.0,0.0
삼미식당 신촌점,16,15,1,93.8,6.2
팜스힐,16,16,0,100.0,0.0
보울룸 신촌점,16,12,4,75.0,25.0
탐복 현대백화점신촌점,16,15,1,93.8,6.2
솔리드웍스 아이스크림,16,16,0,100.0,0.0
낭만식탁,16,16,0,100.0,0.0
피자스쿨 이대점,16,16,0,100.0,0.0
라장훠궈,16,16,0,100.0,0.0
라이프커피컴퍼니,16,15,1,93.8,6.2
피자보이시나 신촌점,16,16,0,100.0,0.0
에이투지 카페,16,16,0,100.0,0.0
카페마지오,16,16,0,100.0,0.0
디델리 이대점,16,16,0,100.0,0.0
한울타리,16,16,0,100.0,0.0
군자대한곱창 신촌점,16,16,0,100.0,0.0
막걸리싸롱,16,16,0,100.0,0.0
제임스시카고피자 신촌점,16,16,0,100.0,0.0
우드문,15,15,0,100.0,0.0
꼼보포차 신촌2호점,15,14,1,93.3,6.7
화가와요리사,15,15,0,100.0,0.0
백암순대국,15,15,0,100.0,0.0
배떡 신촌점,15,15,0,100.0,0.0
소오밥집,15,15,0,100.0,0.0
완차이,15,15,0,100.0,0.0
이디야 신촌기차역점,15,15,0,100.0,0.0
봉추찜닭 신촌점,15,11,4,73.3,26.7
신촌고기창고,15,14,1,93.3,6.7
에일크루,15,15,0,100.0,0.0
청춘대로,15,14,1,93.3,6.7
야채를담다,15,15,0,100.0,0.0
이코노스시본점,15,15,0,100.0,0.0
크로플덕오리아가씨 신촌점,14,13,1,92.9,7.1
아소비바,14,13,1,92.9,7.1
와우끝집,14,14,0,100.0,0.0
거북이의주방,14,14,0,100.0,0.0
장미맨숀 신촌점,14,14,0,100.0,0.0
신참떡볶이 이대점,14,14,0,100.0,0.0
지오짱조개구이,14,14,0,100.0,0.0
팔색콩불,14,14,0,100.0,0.0
제주도로담,14,14,0,100.0,0.0
이나닭강정 신촌점,14,14,0,100.0,0.0
코바코 신촌점,14,13,1,92.9,7.1
만추 현대백화점신촌점,14,12,2,85.7,14.3
오늘와인한잔 신촌역점,14,13,1,92.9,7.1
참참참,14,14,0,100.0,0.0
돌아온의정부부대찌개,14,11,3,78.6,21.4
삼호복집,13,13,0,100.0,0.0
유원섬커피,13,13,0,100.0,0.0
오늘와인한잔 연대가든점,13,12,1,92.3,7.7
초코블로썸,13,13,0,100.0,0.0
소도적,13,13,0,100.0,0.0
에그 앤드 스푼레이스,13,13,0,100.0,0.0
마이시크릿메이트,13,13,0,100.0,0.0
신촌돈부리모노,13,13,0,100.0,0.0
동해횟집,13,12,1,92.3,7.7
한신포차 신촌점,13,12,1,92.3,7.7
신신포차,13,13,0,100.0,0.0
아비꼬 이대점,13,12,1,92.3,7.7
더도이축산직영점 신촌점,13,13,0,100.0,0.0
한강로칼국수 현대백화점 신촌점,13,13,0,100.0,0.0
자연담은화로 신촌점,13,13,0,100.0,0.0
폼프리츠 신촌점,13,13,0,100.0,0.0
고래고래신촌점,13,12,1,92.3,7.7
아비꼬 신촌점,12,12,0,100.0,0.0
대구삼겹살,12,12,0,100.0,0.0
맨도롱 식당,12,12,0,100.0,0.0
굿바이슈가베어 포케&샐러드,12,12,0,100.0,0.0
조선의 육개장 칼국수,12,11,1,91.7,8.3
봉구비어 신촌명물거리2호점,12,12,0,100.0,0.0
유채우 요리사랑,12,12,0,100.0,0.0
신촌해물칼국수,12,12,0,100.0,0.0
반이학생마라탕마라반,12,12,0,100.0,0.0
카페 문베어,12,12,0,100.0,0.0
원앤온리커피,12,11,1,91.7,8.3
클로버,12,12,0,100.0,0.0
죠티레스토랑,12,12,0,100.0,0.0
홍미닭발 신촌점,12,11,1,91.7,8.3
불타는곱창 신촌점,12,11,1,91.7,8.3
잠바주스 연세대학교점,11,11,0,100.0,0.0
우리이동갈비,11,11,0,100.0,0.0
청담동포장마차,11,11,0,100.0,0.0
구복,11,11,0,100.0,0.0
벨라프라하,11,11,0,100.0,0.0
육회본가 신촌점,11,11,0,100.0,0.0
신의주찹쌀순대 신촌점,11,9,2,81.8,18.2
투다리 신촌1호점,11,10,1,90.9,9.1
정정아식당 신촌직영점,11,10,1,90.9,9.1
낮과밤,11,11,0,100.0,0.0
통큰 장모님 밥상,11,11,0,100.0,0.0
명성양꼬치 신촌본점,11,11,0,100.0,0.0
마이도야 현대백화점신촌점,11,11,0,100.0,0.0
포석정,11,11,0,100.0,0.0
계백집 현대백화점 신촌점,11,8,3,72.7,27.3
홍초불닭 신촌본점,11,10,1,90.9,9.1
파티오,11,11,0,100.0,0.0
예소원,11,11,0,100.0,0.0
만냥하우스,11,11,0,100.0,0.0
인생식당,11,11,0,100.0,0.0
고기랑,10,9,1,90.0,10.0
이자카야 류,10,10,0,100.0,0.0
청년국수,10,9,1,90.0,10.0
헤븐,10,10,0,100.0,0.0
써밋컬쳐 신촌,10,9,1,90.0,10.0
강릉아구찜,10,9,1,90.0,10.0
통통돼지,10,10,0,100.0,0.0
고래파스타,10,10,0,100.0,0.0
마포돼지불백,10,10,0,100.0,0.0
후쿠스시,10,10,0,100.0,0.0
이삭토스트 창천점,10,10,0,100.0,0.0
종로김밥 신촌역점,10,10,0,100.0,0.0
스시가마시 이대점,10,10,0,100.0,0.0
가마마루이라멘,10,10,0,100.0,0.0
카페코지 이화여대점,10,10,0,100.0,0.0
북카페파오,10,10,0,100.0,0.0
본도시락 이대점,10,10,0,100.0,0.0
노란집,10,10,0,100.0,0.0
짚신매운갈비찜 신촌점,10,10,0,100.0,0.0
야곱의축복 신촌점,10,10,0,100.0,0.0
김덕후의곱창조 신촌점,10,10,0,100.0,0.0
아워즈,10,10,0,100.0,0.0
해신포차,9,8,1,88.9,11.1
릴리우드,9,9,0,100.0,0.0
1987피자,9,9,0,100.0,0.0
찰리주막 신촌점,9,9,0,100.0,0.0
다발김치찌개,9,8,1,88.9,11.1
하노이포 본점,9,9,0,100.0,0.0
공복식당,9,9,0,100.0,0.0
뉴욕비앤씨 신촌본점,9,9,0,100.0,0.0
데이지,9,9,0,100.0,0.0
동해해물탕,9,9,0,100.0,0.0
잉치킨 신촌점,9,9,0,100.0,0.0
진돈부리,9,9,0,100.0,0.0
베이직프라이드치킨 신촌직영점,9,9,0,100.0,0.0
인생설렁탕 연세대SK국제학사점,9,9,0,100.0,0.0
veganique,9,9,0,100.0,0.0
전주파전,9,9,0,100.0,0.0
엘라도수제아이스크림,9,9,0,100.0,0.0
Quid,9,9,0,100.0,0.0
길상양꼬치,9,9,0,100.0,0.0
모리츠플라츠,9,9,0,100.0,0.0
강산애,9,9,0,100.0,0.0
밥이꿀바비꿀,9,9,0,100.0,0.0
리화인아이스크림와플,9,9,0,100.0,0.0
신미불닭발,8,8,0,100.0,0.0
시골농장,8,8,0,100.0,0.0
초당쌈밥,8,7,1,87.5,12.5
달리는커피 신촌역점,8,8,0,100.0,0.0
요이스시,8,8,0,100.0,0.0
일품92하우스,8,8,0,100.0,0.0
사워도우 랩,8,8,0,100.0,0.0
코지라운지,8,7,1,87.5,12.5
남도밥상,8,8,0,100.0,0.0
카페아늑,8,7,1,87.5,12.5
홍곱창 신촌점,8,8,0,100.0,0.0
하우스라운지,8,8,0,100.0,0.0
김덕후의 차돌조,8,8,0,100.0,0.0
디저트샵 이브흐,8,8,0,100.0,0.0
카페 지니,8,8,0,100.0,0.0
은희네 돈까스,8,8,0,100.0,0.0
올그릭투미,7,7,0,100.0,0.0
의원상 이대점,7,7,0,100.0,0.0
통인동커피공방 신촌로스팅라이브러리,7,7,0,100.0,0.0
장군찜닭,7,7,0,100.0,0.0
동강참치,7,7,0,100.0,0.0
카페봄봄 이화여대점,7,7,0,100.0,0.0
홍대24시스파 스낵,7,7,0,100.0,0.0
수퍼파인,7,6,1,85.7,14.3
쭈꾸미달인 신촌점,7,7,0,100.0,0.0
신촌영양센터,7,7,0,100.0,0.0
꽃피다이화다방,7,7,0,100.0,0.0
죽해수산,7,7,0,100.0,0.0
카페슬래시,7,7,0,100.0,0.0
최완식참치,7,5,2,71.4,28.6
이가네설렁탕,7,7,0,100.0,0.0
오렌지룸 신촌점,7,7,0,100.0,0.0
더숲키친,7,7,0,100.0,0.0
신화장,7,7,0,100.0,0.0
명물갈비,7,7,0,100.0,0.0
파이홀,6,6,0,100.0,0.0
살롱드느루,6,6,0,100.0,0.0
굽네치킨 신촌점,6,6,0,100.0,0.0
원할머니보쌈족발 신촌점,6,6,0,100.0,0.0
여래여거,6,6,0,100.0,0.0
걸작떡볶이치킨 신촌점,6,6,0,100.0,0.0
책다방 위숨,6,4,2,66.7,33.3
압구정샤브샤브 신촌점,6,5,1,83.3,16.7
아마이,6,5,1,83.3,16.7
뉴타운,6,5,1,83.3,16.7
우리집식당,6,6,0,100.0,0.0
순살만공격 마포신촌점,6,6,0,100.0,0.0
리틀쿠바 현대백화점유플렉스신촌점,6,6,0,100.0,0.0
거품1,6,6,0,100.0,0.0
육쌈냉면 이대점,6,6,0,100.0,0.0
논지당,6,6,0,100.0,0.0
오늘와인한잔 이대역점,6,6,0,100.0,0.0
신촌브루스,6,6,0,100.0,0.0
버블티킹 신촌점,6,6,0,100.0,0.0
산타비,6,6,0,100.0,0.0
KMGM 신촌점,6,6,0,100.0,0.0
패스트카페 신촌점,5,5,0,100.0,0.0
세아마라탕,5,4,1,80.0,20.0
돈노코돈먹기 이대점,5,5,0,100.0,0.0
코비노래타운 신촌점,5,4,1,80.0,20.0
남도벌교음식점,5,4,1,80.0,20.0
리버트리커피,5,5,0,100.0,0.0
엠아이스위트,5,5,0,100.0,0.0
빠빠빠치킨 연대본점,5,4,1,80.0,20.0
히우카우,5,5,0,100.0,0.0
피자나라치킨공주 신촌점,5,5,0,100.0,0.0
다모토리,5,5,0,100.0,0.0
이자카야 류 2호점,5,4,1,80.0,20.0
카페HE,5,5,0,100.0,0.0
아키,5,5,0,100.0,0.0
벽제갈비 신촌점,5,4,1,80.0,20.0
네네치킨 이대역점,5,5,0,100.0,0.0
비틀즈,5,5,0,100.0,0.0
치즈를사랑한찜닭 신촌본점,5,5,0,100.0,0.0
인도야시장 신촌점,5,5,0,100.0,0.0
따띠삼겹 이대점,5,5,0,100.0,0.0
아임요거트&아이스크림 이화점,5,5,0,100.0,0.0
와인집,5,5,0,100.0,0.0
엄마손김밥,5,5,0,100.0,0.0
고바우,5,4,1,80.0,20.0
Dana Bakeshop,5,4,1,80.0,20.0
한옥숯불돼지갈비,5,5,0,100.0,0.0
태백산맥,5,5,0,100.0,0.0
동네아저씨 신촌점,5,5,0,100.0,0.0
신촌갈매기,5,5,0,100.0,0.0
설맥 신촌점,5,5,0,100.0,0.0
홍보석,5,5,0,100.0,0.0
한우곱창,5,5,0,100.0,0.0
2대족발,5,5,0,100.0,0.0
신촌양꼬치,5,5,0,100.0,0.0
피망과토마토,4,4,0,100.0,0.0
준코 연세대점,4,4,0,100.0,0.0
낙원스낵 신촌점,4,4,0,100.0,0.0
탕화쿵부,4,4,0,100.0,0.0
치즈문,4,4,0,100.0,0.0
악동포차,4,4,0,100.0,0.0
대명꼬기,4,4,0,100.0,0.0
춘풍식리양꼬치,4,4,0,100.0,0.0
타코마씸 신촌점,4,4,0,100.0,0.0
훼드라,4,3,1,75.0,25.0
앨리스,4,4,0,100.0,0.0
카페스페이스,4,3,1,75.0,25.0
까미네 닭강정,4,4,0,100.0,0.0
119등갈비,4,4,0,100.0,0.0
LP시대,4,4,0,100.0,0.0
크리스터 치킨,4,4,0,100.0,0.0
치킨을사랑한떡볶이 서울이대점,4,4,0,100.0,0.0
막퍼주는집,4,4,0,100.0,0.0
육연소,4,4,0,100.0,0.0
본도시락 신촌점,4,4,0,100.0,0.0
파가니니,4,4,0,100.0,0.0
함평면옥,4,3,1,75.0,25.0
바프로,4,4,0,100.0,0.0
비어어클락,4,4,0,100.0,0.0
꼬뜨 레스토랑,4,4,0,100.0,0.0
콩카페,4,4,0,100.0,0.0
담,4,4,0,100.0,0.0
김사부 브런치&지엔빙,4,4,0,100.0,0.0
와플덴 이대정문점,3,3,0,100.0,0.0
신촌오빠네옛날떡볶이,3,3,0,100.0,0.0
다트펍 신촌상회,3,2,1,66.7,33.3
커피콩즙,3,3,0,100.0,0.0
허니꼬꼬,3,3,0,100.0,0.0
중국산서찜면,3,3,0,100.0,0.0
사케즈키,3,3,0,100.0,0.0
모닭모닭,3,3,0,100.0,0.0
내사랑,3,3,0,100.0,0.0
파란상자,3,3,0,100.0,0.0
일미리금계찜닭 신촌점,3,3,0,100.0,0.0
춘삼국수,3,3,0,100.0,0.0
송학,3,3,0,100.0,0.0
one of c,3,3,0,100.0,0.0
판자집,3,3,0,100.0,0.0
무교동낙지골,3,2,1,66.7,33.3
도넛킬러 현대백화점신촌점,3,2,1,66.7,33.3
로프트,3,3,0,100.0,0.0
홍대돈부리 신촌점,3,3,0,100.0,0.0
섬진강민물장어,3,3,0,100.0,0.0
카페프루티,3,3,0,100.0,0.0
한창희천하일면,3,3,0,100.0,0.0
Messier,3,3,0,100.0,0.0
민주네 김밥,3,3,0,100.0,0.0
꽁술,3,3,0,100.0,0.0
카페언더우드,3,3,0,100.0,0.0
전주식당,3,3,0,100.0,0.0
대포,3,3,0,100.0,0.0
오리총재 신촌점,3,3,0,100.0,0.0
썬더치킨 신촌연대점,3,3,0,100.0,0.0
대족장,3,3,0,100.0,0.0
신촌다성수산,3,3,0,100.0,0.0
기중상점,3,3,0,100.0,0.0
처갓집양념치킨 신촌점,3,3,0,100.0,0.0
이태리마담 신촌점,3,3,0,100.0,0.0
마미골,3,3,0,100.0,0.0
브라더한정식도시락 신촌점,3,3,0,100.0,0.0
티문 카페,3,3,0,100.0,0.0
젊은소나무,3,3,0,100.0,0.0
할리비어 신촌점,3,2,1,66.7,33.3
라마커피,3,3,0,100.0,0.0
오퍼스,2,2,0,100.0,0.0
신촌부추곱창,2,2,0,100.0,0.0
야키토리연,2,2,0,100.0,0.0
폴어반,2,2,0,100.0,0.0
덮밥만드는남자 이대점,2,2,0,100.0,0.0
싱싱참치,2,2,0,100.0,0.0
카츠업,2,2,0,100.0,0.0
LAFL,2,1,1,50.0,50.0
청화원,2,2,0,100.0,0.0
단골손님 신촌점,2,2,0,100.0,0.0
미분당,2,2,0,100.0,0.0
아무술집 신촌점,2,1,1,50.0,50.0
예즈지,2,2,0,100.0,0.0
셀리스도넛,2,2,0,100.0,0.0
다모토리7,2,2,0,100.0,0.0
타이완소야 신촌본점,2,2,0,100.0,0.0
정육면체,2,2,0,100.0,0.0
가례원,2,2,0,100.0,0.0
카라멘야,2,2,0,100.0,0.0
인생이막창이네,2,2,0,100.0,0.0
담산신촌본점,2,2,0,100.0,0.0
두꺼비로멘스 신촌점,2,2,0,100.0,0.0
썸타로사주 타로카페썸,2,2,0,100.0,0.0
예체능,2,2,0,100.0,0.0
두찜 신촌점,2,2,0,100.0,0.0
시나위,2,2,0,100.0,0.0
마포깐풍기,2,2,0,100.0,0.0
이자카야류 3호점,2,2,0,100.0,0.0
펀비어킹 신촌 유플렉스점,2,2,0,100.0,0.0
마포등심,2,2,0,100.0,0.0
ATTA,2,2,0,100.0,0.0
샌드프레소 연대동문점,2,2,0,100.0,0.0
비올라,2,2,0,100.0,0.0
카페달빛,2,2,0,100.0,0.0
김밥천국,2,1,1,50.0,50.0
작은카페,2,2,0,100.0,0.0
플로루스,2,2,0,100.0,0.0
정원식당,2,2,0,100.0,0.0
동학물갈비,2,2,0,100.0,0.0
생육회관,2,2,0,100.0,0.0
씽킹인사이드더박스,2,2,0,100.0,0.0
통통닭,2,2,0,100.0,0.0
천하튀김꼬치 신촌6호점,2,2,0,100.0,0.0
잭아저씨족발&보쌈 홍대점,2,2,0,100.0,0.0
카페리세 신촌점,2,2,0,100.0,0.0
주객전도,2,2,0,100.0,0.0
키친31,2,1,1,50.0,50.0
포크라이언 커피,2,2,0,100.0,0.0
제이스바,2,2,0,100.0,0.0
진미오향왕족발,2,2,0,100.0,0.0
육칠이 신촌점,2,2,0,100.0,0.0
the Panini,2,2,0,100.0,0.0
낭만포차노가리,2,2,0,100.0,0.0
아리랑노점 이대본점,2,2,0,100.0,0.0
아임카츠,2,2,0,100.0,0.0
호밀밭,1,1,0,100.0,0.0
카페자리,1,1,0,100.0,0.0
항아리분식,1,1,0,100.0,0.0
조이버거,1,1,0,100.0,0.0
맛있는식사,1,1,0,100.0,0.0
야바이,1,1,0,100.0,0.0
준스그릴,1,1,0,100.0,0.0
롤러프레시,1,1,0,100.0,0.0
크림온케이크,1,1,0,100.0,0.0
돈카춘 이대점,1,1,0,100.0,0.0
푸른바다찜탕,1,1,0,100.0,0.0
뉴욕11번가앤치킨클럽,1,1,0,100.0,0.0
세븐레드 홀덤펍 신촌점,1,1,0,100.0,0.0
돈이면돼지 신촌점,1,1,0,100.0,0.0
포트캔커피 신촌점,1,1,0,100.0,0.0
그릭데이이대본점,1,1,0,100.0,0.0
스탠바이키친,1,1,0,100.0,0.0
신촌황소곱창,1,1,0,100.0,0.0
꼬숑돈까스,1,1,0,100.0,0.0
그대를 위한 커피,1,1,0,100.0,0.0
히마진,1,1,0,100.0,0.0
논탄토,1,1,0,100.0,0.0
파스타의 왕자,1,1,0,100.0,0.0
바 틸트,1,1,0,100.0,0.0
키친봄날,1,1,0,100.0,0.0
네이버후드,1,1,0,100.0,0.0
쏙만두,1,1,0,100.0,0.0
프레퍼스다이어트푸드,1,1,0,100.0,0.0
유닭스토리닭한마리신촌점,1,0,1,0.0,100.0
배바위양곱창,1,1,0,100.0,0.0
치킨더홈 서울이대점,1,1,0,100.0,0.0
영심이네감자탕,1,1,0,100.0,0.0
맵,1,1,0,100.0,0.0
울리에,1,1,0,100.0,0.0
제주돈1848,1,1,0,100.0,0.0
다모토리3,1,1,0,100.0,0.0
옥이네 김치찌개와 직화삼겹,1,1,0,100.0,0.0
세시봉,1,1,0,100.0,0.0
"육회, 꽃피다",1,1,0,100.0,0.0
고향,1,1,0,100.0,0.0
카페모나티,1,1,0,100.0,0.0
커스텀아토,1,1,0,100.0,0.0
신계치라면,1,0,1,0.0,100.0
바 코디얼,1,1,0,100.0,0.0
양,1,1,0,100.0,0.0
1943 신촌점,1,1,0,100.0,0.0
한바가지,1,1,0,100.0,0.0
네오치킨 신촌점,1,1,0,100.0,0.0
젊음의행진,1,1,0,100.0,0.0
영월다한우,1,1,0,100.0,0.0
바코드,1,1,0,100.0,0.0
라플로르,1,1,0,100.0,0.0
맥주바다,1,1,0,100.0,0.0
목포집,1,1,0,100.0,0.0
더블유루프탑,1,1,0,100.0,0.0
SOLID ACE,1,1,0,100.0,0.0
비니네샐러드,1,1,0,100.0,0.0
다모토리2,1,1,0,100.0,0.0
쿠리야,1,1,0,100.0,0.0
체셔캣,1,1,0,100.0,0.0
북카페/서점 피터캣,1,1,0,100.0,0.0
만남양꼬치,1,1,0,100.0,0.0
아웃백스테이크하우스신촌점,1,1,0,100.0,0.0
