호텔,리뷰 개수,긍정 리뷰 개수,부정 리뷰 개수,긍정 리뷰 비율,부정 리뷰 비율
도토리가든,316,302,14,95.6,4.4
어니언 안국,259,241,18,93.1,6.9
오설록 티하우스 북촌점,182,178,4,97.8,2.2
진작카키,180,174,6,96.7,3.3
블루보틀 삼청 카페,171,154,17,90.1,9.9
삼방매,160,155,5,96.9,3.1
소금집델리 안국,147,142,5,96.6,3.4
핑크래빗가든,134,131,3,97.8,2.2
모자이크 베이커리 북촌점,129,129,0,100.0,0.0
퀸즈베이커리 삼청점,129,128,1,99.2,0.8
땡스오트 안국,126,124,2,98.4,1.6
프릳츠 원서점,119,113,6,95.0,5.0
노란상소갈비 안국역점,111,105,6,94.6,5.4
경춘자의라면땡기는날,105,98,7,93.3,6.7
오픈원,104,99,5,95.2,4.8
갓잇 안국점,97,91,6,93.8,6.2
커피브론즈,91,88,3,96.7,3.3
북촌김치재,89,87,2,97.8,2.2
침스버거,87,85,2,97.7,2.3
베커린 안국점,86,84,2,97.7,2.3
우드앤브릭,83,77,6,92.8,7.2
안암,81,78,3,96.3,3.7
도트블랭킷 안국점,81,78,3,96.3,3.7
플롭 안국,78,75,3,96.2,3.8
언코르크드,78,78,0,100.0,0.0
백미당 삼청점,75,73,2,97.3,2.7
순이네가게,75,69,6,92.0,8.0
연남토마 북촌점,74,67,7,90.5,9.5
대림국수 안국점,73,66,7,90.4,9.6
도라보울,71,67,4,94.4,5.6
어텐디 북촌,64,63,1,98.4,1.6
애호락,63,59,4,93.7,6.3
텅,63,59,4,93.7,6.3
벨라쿠키 안국,62,60,2,96.8,3.2
일월카츠,62,61,1,98.4,1.6
RadioM 삼청점,61,61,0,100.0,0.0
데시데,58,58,0,100.0,0.0
청수정,57,55,2,96.5,3.5
먹쉬돈나 삼청동점,56,46,10,82.1,17.9
썸머골드,55,54,1,98.2,1.8
꽃누리들밥 경복궁점,55,54,1,98.2,1.8
티테라피,54,52,2,96.3,3.7
기와탭룸,52,52,0,100.0,0.0
아티장 크로아상,52,48,4,92.3,7.7
몽중헌 안국점,50,49,1,98.0,2.0
마음을담아내면,50,48,2,96.0,4.0
월영당 서울,50,50,0,100.0,0.0
스미스가좋아하는한옥,50,49,1,98.0,2.0
공공재 커피클럽,47,46,1,97.9,2.1
스미레돈카츠 안국점,46,44,2,95.7,4.3
회화나무,46,45,1,97.8,2.2
정담은보쌈 북촌점,45,44,1,97.8,2.2
팔발라 삼청본점,44,41,3,93.2,6.8
베테카텐,44,41,3,93.2,6.8
편안한집,44,43,1,97.7,2.3
이화돈까스,43,40,3,93.0,7.0
르꼬숑,42,42,0,100.0,0.0
부띠끄경성,42,39,3,92.9,7.1
비어셰프냐항,42,41,1,97.6,2.4
미트볼라운지 X 아날로그키친 삼청점,42,40,2,95.2,4.8
슬로우파크,41,41,0,100.0,0.0
브루다 안국,41,36,5,87.8,12.2
북촌손만두 삼청동점,41,37,4,90.2,9.8
커넥트계동,41,41,0,100.0,0.0
부영도가니탕,40,39,1,97.5,2.5
자작나무이야기,40,37,3,92.5,7.5
조선김밥,40,40,0,100.0,0.0
감동칩스 북촌본점,38,36,2,94.7,5.3
고메오드,38,38,0,100.0,0.0
만가타,38,38,0,100.0,0.0
시래기담은,38,38,0,100.0,0.0
아이사구아,37,36,1,97.3,2.7
대장장이화덕피자,37,35,2,94.6,5.4
마산해물아구찜,37,36,1,97.3,2.7
퀸넬브릴 삼청,37,35,2,94.6,5.4
등촌샤브칼국수 안국역점,36,35,1,97.2,2.8
델픽,36,35,1,97.2,2.8
모퉁이네,36,33,3,91.7,8.3
리틀버틀러,35,34,1,97.1,2.9
밀과보리,35,34,1,97.1,2.9
개성철렵 & 루프탑 나위,34,34,0,100.0,0.0
브릭샌드 삼청점,34,32,2,94.1,5.9
콜디우드 안국,33,29,4,87.9,12.1
리김밥 현대건설점,32,30,2,93.8,6.2
하프커피 안국,32,31,1,96.9,3.1
오뉴하우스,32,32,0,100.0,0.0
카페진선,32,30,2,93.8,6.2
청국장밥,32,28,4,87.5,12.5
삼청빙수,31,26,5,83.9,16.1
비담 CAFE&BAR,31,28,3,90.3,9.7
비원손칼국수,31,28,3,90.3,9.7
노우즈안국,31,31,0,100.0,0.0
아비꼬 안국역점,30,29,1,96.7,3.3
미술관옆 돈까스,30,29,1,96.7,3.3
카페포엠 북촌점,30,25,5,83.3,16.7
국수명가,30,23,7,76.7,23.3
이채 카페,30,30,0,100.0,0.0
행복한 베이커리카페,30,30,0,100.0,0.0
눈나무집,29,29,0,100.0,0.0
헤비스테이크 안국역점,29,28,1,96.6,3.4
인사동쭈꾸미,28,26,2,92.9,7.1
동백식당,28,28,0,100.0,0.0
그린마일커피 북촌점,27,27,0,100.0,0.0
화양연화,27,26,1,96.3,3.7
온6.5,27,26,1,96.3,3.7
지유가오카핫초메 삼청점,27,25,2,92.6,7.4
달,26,25,1,96.2,3.8
꿀밥상,26,24,2,92.3,7.7
온더그라운드,25,22,3,88.0,12.0
별궁식당,25,24,1,96.0,4.0
쏘리 에스프레소바 창덕궁점,25,25,0,100.0,0.0
담미온 안국점,25,24,1,96.0,4.0
반타이,24,24,0,100.0,0.0
비엣 꽌,23,22,1,95.7,4.3
황금정,23,23,0,100.0,0.0
카페로쏘,23,21,2,91.3,8.7
제이네,23,21,2,91.3,8.7
런던베이글뮤지엄,22,21,1,95.5,4.5
네마커피 삼청점,22,22,0,100.0,0.0
피크닉,22,21,1,95.5,4.5
부빙,22,22,0,100.0,0.0
은설설렁탕,21,21,0,100.0,0.0
무에,21,20,1,95.2,4.8
아재커피 북촌점 AZE COFFEE,20,20,0,100.0,0.0
북촌쭈꾸미,20,17,3,85.0,15.0
앙시엔,20,20,0,100.0,0.0
바스켓12 계동,20,20,0,100.0,0.0
호랑이카레,20,19,1,95.0,5.0
호아드 카페&갤러리,20,18,2,90.0,10.0
하궁,19,18,1,94.7,5.3
황칠가 안국점,18,18,0,100.0,0.0
계동피자,18,18,0,100.0,0.0
커피 팩토리,18,16,2,88.9,11.1
더베이커스테이블,18,16,2,88.9,11.1
아트마,18,18,0,100.0,0.0
삼청동 로마네꽁띠,18,18,0,100.0,0.0
길운구락부 & Bar,18,18,0,100.0,0.0
꽃밥에피다 북촌 친환경 그로서란트,18,18,0,100.0,0.0
백년토종삼계탕,17,16,1,94.1,5.9
삼지,17,17,0,100.0,0.0
다락정,17,17,0,100.0,0.0
계동 이잌,17,17,0,100.0,0.0
프레스도넛 북촌다방점,17,17,0,100.0,0.0
뭉치바위,17,17,0,100.0,0.0
CFlamingo,17,17,0,100.0,0.0
만수의정원,16,15,1,93.8,6.2
재동맥주,16,13,3,81.2,18.8
아붕,16,16,0,100.0,0.0
커피로드102,16,16,0,100.0,0.0
북촌막국수,16,15,1,93.8,6.2
고디바 삼청점,16,16,0,100.0,0.0
카페3청,16,16,0,100.0,0.0
북촌호떡,16,16,0,100.0,0.0
카페 르꽁뜨,16,16,0,100.0,0.0
와이엔,16,14,2,87.5,12.5
베르트,15,15,0,100.0,0.0
플로라,15,15,0,100.0,0.0
실리그린,15,15,0,100.0,0.0
까페 골목숲,15,14,1,93.3,6.7
카페다겸,15,15,0,100.0,0.0
후스테이블,14,13,1,92.9,7.1
단상,14,10,4,71.4,28.6
봉궁,14,14,0,100.0,0.0
계동만담,14,14,0,100.0,0.0
아키,14,13,1,92.9,7.1
교촌치킨 안국점,14,13,1,92.9,7.1
카타딘,13,13,0,100.0,0.0
아재커피 삼청점,13,13,0,100.0,0.0
소선재,13,11,2,84.6,15.4
푸드떼,13,13,0,100.0,0.0
이니미니마니모,13,12,1,92.3,7.7
향나무세그루,13,12,1,92.3,7.7
전다,13,10,3,76.9,23.1
카페죠꽁드,13,13,0,100.0,0.0
미돈,12,8,4,66.7,33.3
콩두부사랑,12,12,0,100.0,0.0
와옥,12,12,0,100.0,0.0
진국곰탕,12,12,0,100.0,0.0
가례원,12,11,1,91.7,8.3
정사장,12,12,0,100.0,0.0
57th Cafe,12,11,1,91.7,8.3
스몰하우스카페,12,12,0,100.0,0.0
랜디스도넛안국점,12,12,0,100.0,0.0
거울한옥 미러룸,12,11,1,91.7,8.3
국빈행성,11,11,0,100.0,0.0
스미스가 좋아하는 테라스,11,11,0,100.0,0.0
묘미,11,11,0,100.0,0.0
파툼,11,9,2,81.8,18.2
키즈나,10,10,0,100.0,0.0
큰기와집,10,9,1,90.0,10.0
서울풍경,10,10,0,100.0,0.0
탈스티,10,10,0,100.0,0.0
라 끌레,10,9,1,90.0,10.0
깡통만두,10,9,1,90.0,10.0
국수명가 가회점,10,9,1,90.0,10.0
한경헌,10,10,0,100.0,0.0
두레 국립현대미술관서울점,10,10,0,100.0,0.0
마칸틴,10,10,0,100.0,0.0
커피방앗간,10,7,3,70.0,30.0
북촌연잎밥,10,10,0,100.0,0.0
브람스,10,10,0,100.0,0.0
중경삼림,9,9,0,100.0,0.0
온마을,9,9,0,100.0,0.0
삼청동김치찌개,9,9,0,100.0,0.0
안국정,9,7,2,77.8,22.2
베이킹 도우,9,9,0,100.0,0.0
소소,9,9,0,100.0,0.0
오복당,9,8,1,88.9,11.1
카페레이서,9,8,1,88.9,11.1
이밥,9,9,0,100.0,0.0
카페이드라,8,8,0,100.0,0.0
묵호횟집,8,7,1,87.5,12.5
북촌집,8,7,1,87.5,12.5
아다지에토,8,8,0,100.0,0.0
북촌진곰탕,8,8,0,100.0,0.0
정애쿠키,8,8,0,100.0,0.0
TXT Coffee,8,8,0,100.0,0.0
희 사블레,8,8,0,100.0,0.0
크렘브,8,8,0,100.0,0.0
다사리아,8,8,0,100.0,0.0
mishmash,8,8,0,100.0,0.0
차향기 듣는 집,8,7,1,87.5,12.5
비어있는 삶,8,7,1,87.5,12.5
더블컵커피,8,8,0,100.0,0.0
원조부대고기,8,8,0,100.0,0.0
화동옥,8,8,0,100.0,0.0
빅스트로우 북촌점,8,7,1,87.5,12.5
소현당,7,7,0,100.0,0.0
파티세리희원,7,7,0,100.0,0.0
용수산 비원점,7,7,0,100.0,0.0
반한닥,7,7,0,100.0,0.0
비언유주얼 삼청점,7,7,0,100.0,0.0
삼청순대국추어탕,7,7,0,100.0,0.0
산체스 막걸리,7,6,1,85.7,14.3
와인이지,7,7,0,100.0,0.0
소격동60,7,7,0,100.0,0.0
마산복집,7,6,1,85.7,14.3
카페호미,6,6,0,100.0,0.0
카페얼티밋,6,6,0,100.0,0.0
카페공드리,6,6,0,100.0,0.0
소온table,6,6,0,100.0,0.0
북촌도담,6,6,0,100.0,0.0
월하보이,6,6,0,100.0,0.0
CAFE D_55,6,5,1,83.3,16.7
카페 델 꼬또네 북촌계동점,6,5,1,83.3,16.7
더한옥,6,6,0,100.0,0.0
보드레 안다미로,6,5,1,83.3,16.7
다운타우너안국점,6,6,0,100.0,0.0
레이어드안국점,6,6,0,100.0,0.0
북촌삼계탕,6,6,0,100.0,0.0
북촌해물,6,6,0,100.0,0.0
단풍나무집 삼청점,6,6,0,100.0,0.0
향가,6,6,0,100.0,0.0
법원,6,6,0,100.0,0.0
률,5,5,0,100.0,0.0
로씨니,5,5,0,100.0,0.0
한뫼촌,5,5,0,100.0,0.0
권사부순대국 삼청점,5,5,0,100.0,0.0
수왕,5,5,0,100.0,0.0
The 0123 샌드위치,5,4,1,80.0,20.0
모미지,5,4,1,80.0,20.0
북촌스토리,5,4,1,80.0,20.0
병천순대전문점,5,4,1,80.0,20.0
벽오동가,5,5,0,100.0,0.0
삼청동 만정,5,5,0,100.0,0.0
안동손칼국수 계동점,5,5,0,100.0,0.0
더 레스토랑,5,5,0,100.0,0.0
코피발리안국점,5,3,2,60.0,40.0
코닉,5,5,0,100.0,0.0
파인콘,5,5,0,100.0,0.0
행복두배통다리치킨,5,5,0,100.0,0.0
마나님 레시피,5,4,1,80.0,20.0
피케이엠가든카페,4,4,0,100.0,0.0
현닭매운탕,4,4,0,100.0,0.0
정원고깃집,4,4,0,100.0,0.0
갈로팡,4,4,0,100.0,0.0
신일룡의 호두파이,4,4,0,100.0,0.0
갤러리더스퀘어,4,4,0,100.0,0.0
안집,4,4,0,100.0,0.0
진성옛날소머리국밥집,4,4,0,100.0,0.0
아꼬떼,4,4,0,100.0,0.0
북촌한식뷔페,4,4,0,100.0,0.0
북촌애가삼도예카페,4,4,0,100.0,0.0
보이차전문점 명가원,4,4,0,100.0,0.0
치킨하우스,4,3,1,75.0,25.0
고이커피,4,4,0,100.0,0.0
카페노티드안국점,3,3,0,100.0,0.0
더그릭,3,3,0,100.0,0.0
우리집,3,3,0,100.0,0.0
곰초밥,3,3,0,100.0,0.0
비원커피,3,3,0,100.0,0.0
지밥,3,3,0,100.0,0.0
오니,3,3,0,100.0,0.0
두가헌 레스토랑,3,3,0,100.0,0.0
첫번째집,3,3,0,100.0,0.0
커피인뜨락,3,3,0,100.0,0.0
유즈라멘안국점,3,2,1,66.7,33.3
돌담집,3,3,0,100.0,0.0
비원떡집,3,3,0,100.0,0.0
황생가칼국수,3,3,0,100.0,0.0
삼청동수제비,3,3,0,100.0,0.0
종로삼대복집,3,3,0,100.0,0.0
삼청동우피,3,2,1,66.7,33.3
바운드리스,3,3,0,100.0,0.0
루이스 카페,3,3,0,100.0,0.0
501커피,3,3,0,100.0,0.0
톤티커피,2,2,0,100.0,0.0
카페 No37,2,2,0,100.0,0.0
Floor For Fiction,2,2,0,100.0,0.0
남원,2,2,0,100.0,0.0
낙타,2,2,0,100.0,0.0
오레노라멘,2,2,0,100.0,0.0
풍경,2,2,0,100.0,0.0
이태리탁,2,1,1,50.0,50.0
차마시는뜰,2,2,0,100.0,0.0
달별,2,2,0,100.0,0.0
가배도삼청점,2,2,0,100.0,0.0
키키붕어빵,2,2,0,100.0,0.0
맛다오리구이,2,2,0,100.0,0.0
북촌손만두북촌점,2,2,0,100.0,0.0
장원식당,2,2,0,100.0,0.0
왕짱구식당,2,1,1,50.0,50.0
정독바,2,2,0,100.0,0.0
의정부부대고기,2,2,0,100.0,0.0
풍년쌀농산,2,2,0,100.0,0.0
잇아웃,2,2,0,100.0,0.0
천하보쌈,2,2,0,100.0,0.0
키사,2,2,0,100.0,0.0
소금집델리안국점,1,1,0,100.0,0.0
동네커피,1,1,0,100.0,0.0
산수인,1,1,0,100.0,0.0
테라로사,1,1,0,100.0,0.0
이태리재,1,1,0,100.0,0.0
배스킨라빈스삼청마당점,1,1,0,100.0,0.0
치골뱅 비어뱅,1,1,0,100.0,0.0
안국 153,1,1,0,100.0,0.0
솔트24,1,1,0,100.0,0.0
콩두 점점,1,1,0,100.0,0.0
기차 앤 초밥,1,1,0,100.0,0.0
Gaga bar,1,1,0,100.0,0.0
3안,1,1,0,100.0,0.0
망고랑 본점,1,1,0,100.0,0.0
몽테뉴,1,1,0,100.0,0.0
로마네 꽁띠,1,1,0,100.0,0.0
명인지가,1,1,0,100.0,0.0
리스트레토2010(Ristretto2010),1,1,0,100.0,0.0
계동107,1,1,0,100.0,0.0
북촌 호떡나들이,1,1,0,100.0,0.0
소소한행복,1,1,0,100.0,0.0
핸디크레프티,1,1,0,100.0,0.0
이디야커피북촌마을점,1,1,0,100.0,0.0
